jobs 50
stage 5
machines 1 5 2 2 5 
*Pro_req*
1 1 1 1 1 1 1 1 1 1 1 1 1 1 1 1 1 1 1 1 1 1 1 1 1 1 1 1 1 1 1 1 1 1 1 1 1 1 1 1 1 1 1 1 1 1 1 1 1 1 
2 5 2 4 1 1 3 5 5 5 1 1 5 5 2 2 2 1 4 4 3 5 5 3 1 2 5 3 1 3 1 2 1 3 5 1 4 4 5 2 4 3 1 1 2 5 3 5 4 1 
1 2 2 1 2 1 1 1 1 2 2 1 2 1 1 2 2 1 1 2 1 2 2 2 2 1 2 2 1 2 1 2 2 1 2 1 1 1 1 1 2 2 1 1 1 2 2 1 2 1 
2 2 1 2 1 1 2 1 2 1 2 2 2 2 1 2 1 2 2 2 1 1 1 2 2 1 1 2 1 1 1 1 1 1 2 2 1 1 2 1 1 2 2 1 1 2 1 2 1 2 
3 5 4 2 1 2 4 3 4 1 5 1 5 2 5 2 4 4 5 4 1 3 5 4 1 2 5 5 2 3 5 5 3 5 1 5 4 1 3 5 3 1 2 1 3 2 4 1 4 5 
*Pro_time*
42 82 80 58 42 46 86 45 21 1 32 88 30 76 89 42 96 95 40 38 58 70 35 48 95 58 39 19 40 53 53 33 33 3 27 94 83 32 72 68 92 27 62 4 68 69 67 85 34 95 
72 30 83 70 41 82 28 19 37 58 23 50 58 50 87 12 92 33 36 58 47 59 71 85 5 15 32 12 54 20 80 52 89 13 93 62 40 6 53 83 34 26 28 63 68 64 74 41 50 11 
16 10 92 8 56 96 38 36 38 10 27 77 52 23 53 9 67 21 12 37 60 98 43 86 98 17 73 7 72 60 36 89 75 91 35 47 33 85 38 89 51 20 85 62 78 1 15 80 49 93 
64 27 17 78 61 72 23 99 5 78 85 81 39 91 99 20 2 66 46 11 25 70 85 96 27 36 99 41 93 77 70 7 76 21 30 15 95 50 55 5 57 11 32 79 16 89 93 38 43 66 
22 50 34 21 25 48 71 48 60 83 94 21 53 46 9 44 77 72 12 25 91 65 84 51 99 63 86 15 50 73 22 97 39 52 55 96 13 77 86 22 98 83 18 56 24 26 20 44 35 2 
