jobs 50
stage 5
machines 3 1 1 3 5 
*Pro_req*
3 1 3 1 2 3 2 2 3 2 3 2 1 2 2 3 3 2 2 3 3 2 1 1 3 3 1 1 2 3 2 1 3 1 3 1 2 1 2 1 2 3 3 3 3 3 2 2 1 3 
1 1 1 1 1 1 1 1 1 1 1 1 1 1 1 1 1 1 1 1 1 1 1 1 1 1 1 1 1 1 1 1 1 1 1 1 1 1 1 1 1 1 1 1 1 1 1 1 1 1 
1 1 1 1 1 1 1 1 1 1 1 1 1 1 1 1 1 1 1 1 1 1 1 1 1 1 1 1 1 1 1 1 1 1 1 1 1 1 1 1 1 1 1 1 1 1 1 1 1 1 
3 1 1 2 3 3 1 1 3 1 1 2 2 3 3 1 1 3 3 3 3 3 1 1 2 3 3 3 3 3 1 3 2 1 3 3 3 2 2 3 3 2 3 3 3 2 3 3 1 2 
2 5 3 2 2 3 1 2 5 1 5 1 4 3 3 4 1 1 1 1 1 3 1 2 1 5 1 4 4 3 2 1 5 4 5 2 2 1 4 5 2 5 3 4 1 4 2 2 3 3 
*Pro_time*
16 38 38 14 32 45 9 56 69 84 95 46 25 25 30 84 88 15 35 12 22 85 79 30 25 86 13 56 30 92 67 58 30 28 21 42 22 49 30 50 73 11 5 60 49 24 1 38 35 44 
81 84 89 4 67 67 40 81 94 40 92 82 37 40 90 42 10 33 86 16 91 13 8 26 3 45 92 72 39 21 20 60 52 20 70 53 99 60 38 22 69 4 13 91 83 96 40 23 34 41 
16 96 92 21 56 74 32 49 95 39 73 9 74 77 54 77 6 27 34 19 41 16 72 42 1 12 39 71 100 11 75 8 64 72 23 89 33 72 18 35 16 82 12 7 97 52 26 82 63 5 
38 36 93 22 88 12 51 81 78 50 85 48 67 59 77 32 6 91 28 76 98 45 18 100 72 66 100 40 83 59 20 20 27 2 14 39 53 26 79 93 25 44 25 66 69 11 54 88 96 19 
2 56 18 65 99 59 52 47 25 91 28 76 99 62 34 94 18 6 91 2 67 27 40 47 100 41 20 93 30 30 66 75 46 40 67 43 27 30 9 1 52 74 88 18 93 36 59 6 9 97 
