jobs 50
stage 5
machines 1 2 5 5 3 
*Pro_req*
1 1 1 1 1 1 1 1 1 1 1 1 1 1 1 1 1 1 1 1 1 1 1 1 1 1 1 1 1 1 1 1 1 1 1 1 1 1 1 1 1 1 1 1 1 1 1 1 1 1 
1 1 2 2 2 1 1 1 2 1 1 2 1 2 1 2 1 1 2 1 1 1 2 1 2 1 1 1 1 2 1 1 2 2 2 1 2 2 1 2 2 1 2 2 2 1 2 2 2 2 
5 2 2 5 4 3 3 4 1 2 3 1 4 2 3 1 5 2 1 1 2 5 5 1 1 3 3 1 4 1 5 2 1 4 5 2 4 1 4 1 2 1 3 5 4 2 4 1 2 4 
4 3 1 2 4 3 4 5 3 1 3 5 5 3 5 1 3 2 3 2 3 1 3 1 5 3 1 4 2 4 5 2 5 1 1 2 4 4 5 3 3 5 5 5 3 4 5 5 3 2 
2 3 3 1 2 2 1 1 1 2 1 3 3 1 2 1 3 1 1 1 1 3 2 3 1 1 3 2 1 1 2 1 3 2 2 1 3 3 2 1 3 1 2 1 3 1 2 2 1 2 
*Pro_time*
1 50 35 72 58 98 44 89 53 31 32 42 14 24 24 55 30 64 47 70 94 38 39 11 81 91 89 70 84 21 57 91 19 8 81 18 63 28 48 65 38 26 80 65 24 4 84 56 67 87 
78 89 48 9 28 7 20 45 75 38 14 33 81 38 28 65 74 67 8 24 90 28 6 92 74 61 69 89 87 31 33 67 99 31 52 21 6 12 10 36 61 88 71 35 26 7 38 18 55 6 
72 7 43 49 95 69 94 81 1 43 2 73 100 36 77 39 29 97 76 26 77 93 97 12 29 56 82 33 79 74 73 39 8 5 28 37 38 5 49 73 52 32 68 14 61 16 70 67 70 32 
99 33 59 44 81 66 25 58 30 62 57 99 87 14 16 72 20 20 50 93 33 32 61 54 63 48 48 88 95 100 34 69 37 35 21 99 79 25 50 27 20 18 53 45 9 7 94 9 21 10 
25 84 30 21 80 50 85 88 2 100 50 28 25 9 65 12 15 57 100 33 47 76 100 10 71 5 59 79 96 54 59 32 27 83 11 43 24 83 95 8 7 15 79 21 82 45 92 30 87 80 
