jobs 50
stage 5
machines 2 5 3 4 1 
*Pro_req*
2 2 2 1 1 2 1 2 2 1 2 2 1 1 1 2 2 2 1 1 2 2 1 1 2 2 1 1 2 1 2 1 2 1 1 1 1 1 2 1 1 2 2 1 1 1 2 1 1 1 
4 5 5 1 2 3 1 5 3 5 4 3 2 3 4 4 1 5 3 1 2 4 2 3 4 2 1 4 2 1 5 2 1 4 5 3 3 2 2 4 2 4 1 3 2 5 2 5 5 3 
1 3 1 1 1 2 3 2 3 1 2 2 2 2 1 1 1 3 2 2 3 2 2 3 3 2 3 1 3 3 2 2 2 1 2 1 1 3 3 1 1 1 1 1 2 2 3 2 3 2 
1 2 3 4 2 4 2 1 3 1 4 1 2 2 3 4 4 2 3 1 2 2 4 1 2 3 4 2 3 4 4 3 1 1 1 2 3 3 4 2 4 4 4 1 3 3 4 2 2 3 
1 1 1 1 1 1 1 1 1 1 1 1 1 1 1 1 1 1 1 1 1 1 1 1 1 1 1 1 1 1 1 1 1 1 1 1 1 1 1 1 1 1 1 1 1 1 1 1 1 1 
*Pro_time*
95 23 96 92 91 54 59 98 60 86 36 66 50 50 14 54 61 21 35 48 52 8 88 85 97 3 13 88 89 42 49 46 66 20 67 55 67 75 22 53 100 60 43 13 72 16 75 22 14 18 
53 80 6 89 35 12 51 5 53 100 18 40 56 85 6 16 74 14 11 18 36 70 64 83 82 68 2 98 42 67 16 100 48 79 16 85 55 46 93 53 35 7 14 77 11 93 68 87 65 11 
18 80 54 90 24 72 29 36 49 69 47 47 59 56 88 69 9 73 44 100 29 22 22 6 31 42 4 6 65 67 26 93 87 30 79 42 12 20 90 23 99 92 32 52 12 57 17 45 5 94 
65 20 67 12 7 26 12 27 82 14 85 91 73 64 69 75 91 47 57 44 13 4 92 78 59 92 60 2 66 63 63 23 40 91 76 9 42 88 75 21 76 25 11 44 3 47 25 32 26 94 
38 58 15 57 85 62 63 72 76 61 3 100 34 36 8 6 74 25 89 77 66 72 17 86 14 32 46 86 12 35 50 1 75 85 84 90 8 50 16 100 36 82 42 100 66 59 92 57 6 72 
