jobs 100
stage 5
machines 5 5 5 5 5 
*Pro_req*
5 3 1 4 4 4 5 5 2 4 3 1 4 2 4 2 4 1 1 2 3 2 3 3 1 4 1 5 3 2 3 1 2 2 5 4 5 5 1 4 2 5 4 1 5 4 5 5 4 3 3 5 5 3 5 4 1 3 5 5 3 3 4 5 4 5 2 5 1 1 4 5 2 2 2 3 3 4 2 1 2 1 1 1 4 2 4 3 4 2 5 1 3 1 2 2 4 1 2 3 
5 1 3 4 2 1 5 5 5 2 4 5 1 4 1 5 5 3 2 3 2 4 3 2 1 4 1 4 2 5 3 4 4 3 4 5 2 2 3 5 2 5 4 2 2 2 3 3 5 3 5 5 5 3 1 5 1 2 4 5 3 2 4 1 3 2 2 4 1 5 2 1 1 1 5 3 1 1 1 5 4 5 5 2 2 4 5 4 3 5 2 5 2 5 1 1 5 3 2 5 
1 3 3 1 1 1 4 2 1 2 1 3 3 4 3 3 4 4 1 2 3 3 2 3 4 4 1 4 2 4 5 4 3 5 1 4 5 1 3 2 5 5 3 2 3 3 1 4 1 5 5 1 4 3 1 5 5 4 1 5 5 4 1 2 3 1 2 5 5 4 1 2 5 4 3 4 1 3 3 3 4 5 2 3 4 1 1 3 5 1 3 1 5 4 2 1 1 4 2 3 
5 5 4 5 5 3 5 2 4 5 4 2 3 2 1 1 1 1 2 4 5 2 3 1 1 2 5 2 1 2 4 5 2 4 5 4 3 4 3 1 3 1 4 3 3 3 4 3 1 2 5 5 1 1 4 5 2 5 3 2 3 2 4 1 5 4 3 5 3 4 4 5 1 4 2 5 5 4 3 2 4 5 3 1 3 4 5 2 2 3 1 3 1 1 1 1 1 2 5 5 
1 2 1 2 5 3 5 4 4 5 2 1 2 1 1 5 4 1 4 5 5 4 1 5 5 4 3 5 1 3 2 1 4 3 3 3 5 3 4 2 3 1 4 4 1 1 3 3 1 3 3 2 2 4 4 2 3 2 1 4 5 1 2 5 2 3 5 4 3 1 3 4 2 3 1 1 2 2 5 2 2 4 4 5 5 5 5 5 2 1 5 1 3 5 4 1 1 4 5 2 
*Pro_time*
27 58 38 18 93 10 80 92 74 2 80 33 52 65 84 74 52 56 46 100 90 72 34 7 87 54 20 55 27 32 33 81 67 68 48 94 72 10 29 56 66 48 13 53 36 29 6 17 98 12 71 96 75 51 48 4 13 4 49 1 100 51 31 99 57 31 24 19 62 29 72 20 58 44 34 72 16 90 21 20 3 50 73 65 55 7 6 76 87 36 2 12 10 66 32 90 56 69 29 98 
85 89 49 26 55 60 10 33 21 58 29 94 27 80 45 41 67 50 57 35 58 70 59 80 63 48 61 21 89 51 53 31 3 85 75 98 27 55 61 31 20 76 87 50 13 44 55 35 66 7 94 91 65 94 70 86 5 34 62 44 35 22 79 57 18 10 22 10 77 23 1 93 19 65 19 61 5 68 15 89 13 40 91 77 42 61 35 18 63 13 55 19 58 32 14 53 7 26 60 9 
53 87 78 96 67 13 89 19 86 73 39 93 73 77 58 9 54 24 35 31 93 22 28 27 2 54 13 15 39 49 29 51 48 6 7 52 97 58 29 45 83 65 47 91 2 31 83 69 48 5 50 19 90 48 90 35 30 23 2 28 40 85 39 47 7 33 25 77 40 56 3 3 100 24 7 77 50 28 46 84 72 74 96 33 62 56 39 6 80 13 94 5 78 49 45 72 86 92 92 35 
24 16 52 41 84 89 64 50 60 29 31 71 32 61 5 52 36 79 65 56 88 91 60 66 99 31 99 45 26 31 37 29 12 2 23 11 84 78 96 77 67 55 9 5 18 95 58 81 20 87 57 94 63 42 12 26 23 13 51 40 78 81 96 11 68 20 80 77 16 4 92 8 76 82 51 85 96 93 32 22 23 48 44 42 75 64 43 47 46 41 54 74 2 68 37 17 80 67 46 33 
37 1 40 54 78 34 77 61 44 1 86 95 49 7 100 28 77 89 10 97 96 90 16 22 89 29 22 1 86 67 45 7 58 56 20 100 31 86 81 2 81 71 30 12 100 89 36 14 41 9 6 26 22 69 63 1 77 43 79 56 38 26 36 64 57 85 13 62 68 38 19 99 32 36 89 88 68 22 88 49 68 78 1 74 2 41 10 39 67 13 96 20 58 45 13 38 8 31 13 50 
