jobs 100
stage 5
machines 5 5 5 5 5 
*Pro_req*
1 5 2 2 5 2 2 5 4 4 1 1 4 2 4 1 1 2 1 5 5 4 4 5 5 4 4 3 4 2 4 2 4 1 5 4 5 3 4 2 3 5 3 5 3 4 3 3 5 2 1 1 2 1 3 3 5 4 3 3 3 5 3 2 1 2 5 2 4 5 3 5 5 2 2 3 4 2 3 5 3 2 1 2 3 3 2 2 1 2 5 5 2 4 4 5 2 4 1 4 
4 4 3 3 1 2 5 3 1 4 2 3 1 1 3 4 2 4 2 1 5 5 2 1 3 3 4 4 4 4 1 3 5 1 3 1 4 5 1 3 2 1 3 1 3 4 4 2 1 2 5 4 1 4 3 1 1 5 1 3 5 2 2 2 1 2 4 3 2 3 1 4 2 1 2 3 5 3 5 5 1 4 1 4 3 2 5 4 5 2 3 2 5 2 5 3 1 5 4 4 
5 5 2 3 4 3 5 4 2 1 2 4 3 4 1 5 1 5 2 5 2 4 4 5 4 1 3 5 4 1 2 5 5 2 3 5 5 3 5 1 5 4 1 3 5 3 1 2 1 3 2 4 1 4 5 2 3 2 2 2 3 4 3 3 5 5 2 3 3 1 3 4 4 1 2 5 4 5 3 5 4 5 1 3 4 2 5 2 3 3 5 1 4 5 2 5 5 1 3 2 
5 1 3 3 4 2 1 3 2 1 3 1 1 4 5 1 1 1 2 3 5 4 4 2 5 3 5 3 1 4 1 4 4 3 3 3 3 4 2 1 2 3 2 2 5 1 4 2 4 1 4 2 3 1 5 4 4 3 2 2 2 4 1 4 3 1 5 3 1 2 4 1 1 3 3 2 2 3 2 3 2 3 4 5 3 5 4 2 4 1 4 4 3 1 4 4 5 4 3 3 
1 5 1 5 5 4 1 3 4 2 2 2 2 3 4 5 2 3 1 5 1 3 3 5 3 5 4 4 4 4 5 1 3 1 5 1 5 5 2 1 1 2 3 2 1 4 2 5 2 3 2 1 5 4 1 5 4 4 2 3 3 2 5 1 5 4 2 4 1 2 2 4 5 1 3 2 4 3 4 5 2 5 3 1 2 2 2 2 4 3 3 5 4 2 5 1 3 3 5 2 
*Pro_time*
69 67 85 34 95 34 84 28 77 10 13 41 95 82 87 12 12 84 83 38 23 26 4 66 76 43 88 93 54 3 39 84 60 5 60 15 35 16 44 86 1 66 72 99 24 71 58 8 16 38 88 42 97 63 15 72 30 83 70 41 82 28 19 37 58 23 50 58 50 87 12 92 33 36 58 47 59 71 85 5 15 32 12 54 20 80 52 89 13 93 62 40 6 53 83 34 26 28 63 68 
1 15 80 49 93 58 94 33 93 8 43 64 11 70 34 100 83 59 71 25 82 7 83 87 58 6 45 37 78 67 25 26 51 47 23 2 46 11 30 89 91 10 7 69 9 14 88 96 24 36 100 7 94 45 53 64 27 17 78 61 72 23 99 5 78 85 81 39 91 99 20 2 66 46 11 25 70 85 96 27 36 99 41 93 77 70 7 76 21 30 15 95 50 55 5 57 11 32 79 16 
26 20 44 35 2 76 60 60 82 28 81 28 85 6 52 80 22 41 61 68 23 100 58 20 13 81 82 97 47 35 74 8 45 74 72 44 77 66 20 26 26 68 85 79 65 60 7 32 33 1 3 44 19 41 34 13 74 38 26 71 44 2 44 43 22 49 57 73 60 7 36 74 60 49 72 90 48 85 5 70 67 73 61 4 46 23 86 88 96 74 57 55 96 54 97 43 47 55 38 19 
87 1 67 84 63 48 72 48 94 2 29 53 25 42 25 88 18 31 20 45 86 74 2 31 54 34 46 85 43 12 22 73 7 54 96 33 29 93 7 23 63 60 56 67 96 79 31 50 41 38 6 85 18 32 64 81 19 70 65 79 77 27 34 35 78 70 14 24 21 65 12 99 34 9 84 79 57 54 42 89 38 87 24 91 49 93 89 50 36 100 73 98 99 12 95 40 91 26 89 84 
69 4 87 83 28 8 24 45 18 55 44 75 77 30 69 67 29 93 69 82 37 48 80 38 13 75 21 54 5 76 69 26 73 47 100 75 5 28 7 24 78 100 33 44 19 50 67 53 17 28 36 55 85 70 100 4 36 9 48 24 14 51 52 8 73 49 96 24 39 65 61 96 30 11 74 57 86 46 61 82 95 13 23 68 31 57 84 70 3 50 67 21 56 30 27 45 100 28 36 10 
