jobs 100
stage 5
machines 5 5 5 5 5 
*Pro_req*
2 1 1 3 1 2 3 1 4 3 3 1 5 5 5 5 5 3 1 2 1 5 3 4 4 2 5 3 5 1 1 3 5 1 1 5 5 2 4 4 1 3 1 3 1 2 5 5 1 1 5 4 1 4 5 4 2 3 1 2 5 4 1 1 4 5 2 1 5 2 2 2 5 1 5 5 3 5 5 4 5 5 1 1 5 2 2 1 1 2 4 4 3 2 1 1 2 5 4 2 
3 5 2 2 3 2 3 5 1 3 3 2 5 2 2 3 4 1 3 2 2 4 5 3 1 1 1 5 1 3 5 4 5 4 2 1 4 1 5 2 4 3 3 2 5 3 4 1 2 1 5 1 4 3 2 4 2 2 4 1 2 3 3 5 3 2 2 5 2 1 3 5 3 5 4 3 3 4 1 2 1 4 4 1 3 3 5 2 5 1 3 5 4 3 4 1 3 3 2 3 
3 4 3 1 4 5 5 5 2 1 1 4 4 1 5 5 2 2 3 2 4 1 4 3 2 2 5 1 4 1 5 3 3 4 4 1 2 1 1 4 4 5 4 2 2 3 4 4 5 1 3 3 1 4 3 3 2 3 2 1 1 1 1 2 1 4 5 5 2 5 3 5 4 4 1 1 3 1 4 5 2 1 1 1 4 1 5 5 2 3 4 1 3 5 5 4 4 5 5 2 
2 2 5 1 2 3 3 3 1 2 3 1 2 4 2 2 4 3 4 4 4 3 4 2 4 4 4 5 3 1 3 1 5 3 5 5 2 2 4 1 1 3 5 1 4 3 2 5 4 4 5 5 3 5 3 2 2 5 5 3 2 3 2 5 2 1 1 4 4 1 1 5 1 3 5 5 1 5 3 5 2 2 1 1 2 3 1 5 4 2 3 3 3 3 3 4 2 4 1 2 
5 4 2 5 1 4 3 1 2 1 3 2 4 5 1 1 2 5 2 3 3 3 5 3 1 5 4 1 2 1 5 1 2 4 2 5 5 2 3 4 5 1 4 2 3 4 5 2 2 4 1 2 4 3 4 1 5 3 1 1 4 3 4 2 1 2 3 4 4 3 4 5 4 4 3 3 3 2 2 1 4 1 3 1 3 1 4 4 5 5 5 4 4 5 1 1 4 1 5 4 
*Pro_time*
38 93 23 24 55 31 98 20 69 1 70 42 39 2 48 48 82 36 59 2 81 85 34 85 76 48 41 30 50 77 42 33 93 73 3 58 20 55 97 35 91 48 100 67 31 16 51 79 94 88 79 41 1 77 15 19 46 95 43 65 33 29 25 39 9 86 32 50 21 12 93 87 86 33 32 95 54 58 35 94 81 96 9 80 7 87 68 15 28 99 41 10 1 41 100 41 66 8 31 74 
51 90 91 36 72 17 2 1 88 28 64 45 23 39 79 96 9 44 98 7 27 94 40 17 24 67 43 93 4 16 25 28 58 74 62 26 100 57 12 75 37 32 11 98 51 65 10 66 25 74 98 63 81 90 54 69 84 94 7 16 5 49 99 41 1 30 46 75 9 10 20 3 45 24 87 10 61 58 52 24 34 49 2 26 50 39 18 12 39 78 87 5 7 90 38 96 42 4 14 3 
39 91 32 72 65 93 47 9 85 54 62 5 7 21 35 5 46 65 96 48 93 44 52 74 37 14 81 7 51 93 84 24 48 70 8 18 57 33 41 46 94 23 39 92 62 44 27 19 1 54 52 27 64 73 13 64 22 53 79 32 41 97 95 68 47 18 95 97 3 99 30 15 74 27 62 77 89 14 89 43 62 45 3 80 47 63 80 37 82 78 98 54 56 5 98 80 98 83 16 85 
12 12 11 84 27 50 87 21 94 97 25 63 21 26 47 11 31 91 66 57 45 45 94 83 36 84 14 42 12 49 89 60 57 68 80 16 24 39 36 5 5 60 33 52 40 72 82 64 98 23 89 33 22 28 53 20 30 38 57 97 72 73 93 61 88 77 16 37 65 13 92 6 70 92 25 70 18 4 25 19 24 45 71 53 62 74 85 46 7 76 80 23 100 85 90 71 20 67 90 77 
55 43 80 47 67 98 1 10 8 34 93 24 52 89 63 56 26 25 30 8 98 32 61 42 38 86 11 68 91 25 18 54 18 21 6 83 86 7 96 10 35 99 29 45 56 39 25 42 60 35 66 84 66 5 75 58 76 89 84 95 17 90 42 6 90 11 99 5 65 17 59 91 69 83 19 43 86 64 63 82 91 16 70 3 54 40 70 36 81 79 33 68 29 17 45 56 29 41 97 54 
