jobs 100
stage 8
machines 5 5 5 5 5 5 5 5 
*Pro_req*
1 2 5 5 3 2 5 1 2 5 4 2 1 2 5 5 4 3 3 5 3 2 3 1 3 5 1 1 3 3 2 4 5 2 4 1 1 4 3 5 2 1 4 1 3 2 3 5 4 5 1 2 3 4 1 1 3 2 4 3 5 3 5 3 2 2 3 1 2 2 3 2 4 3 4 5 2 2 1 5 5 5 4 5 2 3 5 1 1 5 1 4 2 3 4 2 2 4 4 2 
1 2 1 3 1 5 2 2 5 4 3 3 4 1 2 3 1 4 2 3 1 5 2 1 1 2 5 5 1 1 3 3 1 4 1 5 2 1 4 5 2 4 1 4 1 2 1 3 5 4 2 4 1 2 4 4 1 3 3 5 4 5 5 1 3 1 4 5 2 4 2 2 5 4 2 4 5 5 1 2 3 5 2 4 4 4 2 1 1 2 2 2 1 3 4 3 2 4 1 4 
1 5 1 2 1 3 5 4 2 4 3 1 2 2 3 1 5 5 1 4 1 5 1 1 2 1 5 3 5 1 1 4 2 2 1 4 2 4 2 2 2 4 5 3 1 5 1 2 1 5 1 3 3 1 3 2 5 2 2 4 3 5 5 1 5 3 2 2 1 4 1 1 3 5 2 3 4 5 1 4 1 3 4 5 3 3 2 2 5 1 3 2 5 5 1 1 1 4 2 5 
2 3 4 5 5 1 2 1 3 2 4 3 1 4 5 4 5 3 2 3 3 3 1 2 5 5 2 4 2 5 1 2 5 1 2 1 4 1 3 2 2 3 4 2 5 3 1 5 5 2 4 3 2 1 3 3 4 2 1 4 5 2 2 1 2 1 1 3 1 4 2 1 1 5 2 3 4 3 2 3 3 1 4 3 2 5 5 1 3 1 1 1 3 2 1 5 2 1 2 3 
4 5 2 1 2 4 5 5 5 2 1 4 1 3 5 3 1 4 4 2 4 2 2 1 5 4 5 5 5 5 1 1 3 4 5 1 2 1 1 2 3 2 2 2 4 2 3 5 2 5 4 2 5 1 5 1 4 1 3 5 5 5 1 2 3 2 5 4 2 5 5 4 4 5 4 2 1 4 1 4 4 3 5 5 5 1 1 5 2 2 4 2 5 1 1 1 1 3 5 4 
2 1 5 1 4 2 2 5 2 2 1 5 5 4 3 3 4 5 3 2 2 2 3 3 1 4 2 5 1 4 2 3 2 2 2 3 2 1 3 4 5 5 5 3 2 3 1 2 1 5 1 4 4 5 1 4 1 5 5 1 1 4 5 4 1 4 3 5 2 1 3 1 2 5 2 1 3 2 5 1 4 3 4 4 1 2 1 1 2 3 2 3 3 5 3 4 1 1 3 3 
3 4 1 3 4 1 3 1 3 2 5 1 1 2 5 3 1 1 4 4 2 4 3 3 3 1 1 2 5 4 1 5 3 2 2 2 1 3 5 1 4 1 1 4 2 4 2 5 1 5 5 4 3 2 1 4 4 1 4 5 3 2 5 4 5 5 4 1 1 3 5 3 1 1 4 3 1 3 1 3 3 3 4 1 2 1 4 3 4 1 5 2 3 1 1 1 5 5 5 2 
1 3 1 3 4 3 3 5 4 4 3 1 5 4 5 4 5 4 3 5 1 5 5 3 4 2 2 5 3 5 4 4 4 5 5 5 5 4 3 4 3 3 3 5 2 1 2 2 2 2 2 2 2 5 4 1 4 2 3 1 5 3 2 5 4 3 4 4 3 5 3 1 3 3 1 3 2 5 5 4 2 5 1 1 4 1 2 4 2 4 2 4 5 1 4 1 4 5 1 4 
*Pro_time*
4 84 56 67 87 39 4 97 70 92 30 43 33 58 28 9 69 44 85 50 56 45 34 66 17 1 28 57 42 91 43 47 8 11 74 47 4 78 70 55 9 89 54 1 90 82 19 92 59 97 19 53 70 98 84 78 89 48 9 28 7 20 45 75 38 14 33 81 38 28 65 74 67 8 24 90 28 6 92 74 61 69 89 87 31 33 67 99 31 52 21 6 12 10 36 61 88 71 35 26 
16 70 67 70 32 68 54 16 29 66 45 69 92 45 7 45 91 98 57 98 18 58 38 53 24 49 9 57 8 83 50 5 67 33 62 84 34 86 16 20 34 75 61 93 60 42 81 83 86 55 62 95 88 46 29 99 33 59 44 81 66 25 58 30 62 57 99 87 14 16 72 20 20 50 93 33 32 61 54 63 48 48 88 95 100 34 69 37 35 21 99 79 25 50 27 20 18 53 45 9 
45 92 30 87 80 13 72 22 2 4 19 40 82 56 96 43 52 23 84 79 46 27 77 69 28 18 35 6 93 61 86 27 77 74 31 74 52 20 96 46 25 40 41 33 22 15 16 25 16 51 99 28 24 16 40 27 35 29 62 63 41 7 3 22 30 42 33 23 5 86 36 75 72 28 85 53 12 25 28 17 22 12 4 11 28 72 29 33 77 56 14 68 56 71 11 94 87 35 77 52 
5 9 28 66 5 13 97 59 29 28 23 90 92 39 24 29 99 86 52 1 33 94 85 92 45 75 71 48 51 67 52 34 17 79 56 41 19 20 22 32 51 10 66 81 93 94 89 40 36 84 73 5 97 49 69 31 30 9 51 37 91 97 99 60 84 13 24 9 7 23 18 7 86 13 90 31 33 67 63 89 38 73 91 41 58 8 38 56 67 97 64 14 37 91 64 28 17 84 89 96 
94 23 63 12 1 67 35 53 67 98 75 7 43 34 6 83 66 57 39 39 94 74 82 22 12 57 95 41 29 38 88 57 35 48 43 23 83 17 92 9 11 6 54 76 72 40 59 17 79 30 74 1 40 80 78 85 26 51 100 81 91 75 13 10 86 38 13 50 28 88 52 42 79 7 21 94 27 38 87 71 92 88 62 47 8 64 42 30 92 95 91 69 99 30 12 86 47 41 21 8 
50 7 74 77 6 22 46 38 90 19 41 51 90 16 64 93 23 92 14 35 86 95 34 17 37 45 96 37 8 51 65 33 17 78 21 100 69 70 58 28 98 41 85 38 53 66 23 77 47 90 25 60 78 71 71 96 25 15 62 42 53 40 71 97 40 1 19 92 28 32 10 51 29 29 84 16 23 75 98 79 30 61 22 77 93 96 62 47 1 60 14 87 88 73 92 3 54 29 100 28 
93 57 52 58 47 44 91 88 44 66 75 18 16 38 73 52 16 60 52 83 88 95 69 23 23 66 6 49 60 14 41 71 3 23 91 92 13 25 20 24 46 80 16 50 8 22 86 86 90 89 52 98 40 21 48 29 50 51 52 100 63 3 97 59 69 87 51 47 90 37 68 39 6 2 95 18 32 79 57 25 55 49 88 31 30 68 29 97 89 52 29 61 32 72 10 16 24 66 11 59 
58 55 61 34 74 32 16 3 60 66 49 45 73 17 1 3 7 38 8 100 20 21 75 78 89 28 56 11 26 1 16 71 73 96 96 38 22 70 76 63 39 43 44 21 81 8 85 99 80 48 49 88 95 56 60 92 74 91 51 8 37 34 80 52 16 7 68 65 83 56 25 6 76 70 57 47 28 58 2 88 50 60 13 25 63 97 25 71 19 74 95 89 46 22 70 75 93 3 30 12 
