jobs 100
stage 8
machines 5 5 5 5 5 5 5 5 
*Pro_req*
4 2 1 2 2 3 1 3 5 4 2 5 5 3 2 2 2 3 5 3 4 2 2 5 4 2 4 2 2 4 2 2 2 4 5 2 2 5 4 5 3 2 5 1 2 1 4 4 3 2 4 1 5 1 5 3 2 4 2 5 4 5 3 1 1 3 5 3 3 2 3 3 2 2 5 5 2 1 1 5 3 4 1 1 2 1 1 2 4 2 3 1 2 5 5 2 5 3 3 3 
5 5 4 4 1 1 3 4 4 5 5 4 2 1 4 1 1 5 5 3 4 1 4 5 5 3 3 1 5 5 5 5 2 2 2 2 2 2 1 5 3 4 4 4 2 1 1 2 4 2 4 2 5 4 1 5 1 5 4 4 3 1 5 2 4 1 2 4 3 2 1 3 2 1 1 5 5 5 2 5 4 3 1 3 2 4 2 4 2 5 3 1 4 1 2 5 2 3 1 1 
1 3 2 4 3 1 2 5 1 2 5 2 4 2 4 1 1 2 3 3 2 1 3 4 3 3 4 3 2 5 1 4 5 2 1 1 1 4 2 2 3 1 2 1 4 5 4 5 4 3 2 3 1 1 2 5 5 1 1 2 5 5 3 5 5 3 3 3 5 1 2 3 5 2 1 4 3 3 2 4 1 4 2 3 2 5 2 2 5 5 5 2 2 4 3 4 4 5 3 3 
4 1 3 1 3 2 2 4 1 3 1 3 4 3 5 5 1 2 1 5 4 4 2 4 1 3 5 5 4 4 5 4 5 4 4 5 3 5 1 2 5 3 5 2 4 2 1 2 5 1 5 3 4 5 1 1 1 1 2 2 3 3 4 3 1 3 4 5 2 5 3 1 4 3 4 4 5 2 5 5 3 2 5 1 4 3 5 4 4 3 2 1 4 2 3 1 1 4 3 5 
5 4 5 3 1 5 5 3 2 1 3 1 3 2 5 2 3 3 3 4 1 1 3 2 3 3 3 3 5 4 3 3 1 3 2 4 5 2 5 1 4 5 2 4 3 2 2 4 5 3 1 4 3 3 2 3 5 5 4 5 1 3 5 5 2 5 5 2 4 5 5 3 2 3 1 3 3 1 5 1 5 1 5 4 4 5 5 2 5 3 3 3 4 2 4 5 5 3 2 3 
3 2 1 2 2 4 5 2 5 5 5 1 2 5 5 5 2 2 3 3 2 4 3 1 4 4 5 4 4 1 4 3 5 2 1 2 4 4 3 1 5 5 5 1 3 1 5 3 5 3 2 3 5 5 2 2 3 1 2 4 1 1 1 4 4 2 2 5 5 3 1 2 1 4 4 2 2 2 2 4 2 2 3 2 3 2 2 2 3 4 3 5 5 3 4 5 1 2 2 3 
5 2 3 1 1 1 4 5 5 2 3 1 1 1 5 3 5 2 3 2 4 4 3 3 4 1 3 5 2 4 1 3 2 4 5 2 2 2 3 3 1 3 1 1 5 2 3 5 1 2 3 4 4 2 4 3 5 2 3 5 4 2 5 4 5 5 2 2 3 2 3 4 2 4 3 1 4 5 4 3 1 5 3 5 1 2 3 1 5 1 1 5 4 3 5 4 2 4 5 5 
2 2 5 2 3 1 2 4 4 2 2 4 5 2 3 4 1 1 5 1 1 5 1 5 4 2 3 3 2 2 4 5 5 1 4 1 2 5 2 2 5 2 3 4 2 2 2 5 2 2 1 2 1 2 4 2 1 3 1 1 5 3 3 4 1 4 2 4 4 3 4 1 2 3 2 4 4 1 4 1 2 2 5 3 1 5 3 2 2 4 5 2 1 2 1 2 3 5 3 5 
*Pro_time*
11 22 83 82 88 94 91 74 100 83 87 24 50 78 68 33 84 55 13 29 85 45 40 98 35 92 38 83 78 19 100 26 6 100 54 1 71 87 12 81 36 90 6 9 17 24 77 7 69 59 30 37 45 60 97 78 46 95 83 73 90 86 89 45 95 17 91 85 38 91 79 67 47 96 80 28 4 96 27 4 92 29 32 28 53 48 2 2 82 62 2 66 29 89 38 79 25 39 55 28 
28 70 62 38 75 77 42 68 74 17 11 1 65 2 10 4 35 7 22 82 82 31 6 69 43 74 89 2 10 51 43 14 93 10 5 70 31 11 44 100 8 12 79 43 86 4 29 35 24 57 54 15 19 58 87 9 8 59 83 32 4 37 30 40 73 44 32 87 97 97 51 15 3 16 14 37 38 40 1 11 25 35 28 53 99 6 49 66 67 33 94 92 96 94 34 82 62 54 96 49 
90 2 45 3 4 92 22 20 97 85 58 14 42 29 80 72 24 56 50 95 28 68 24 90 33 31 60 45 48 42 56 62 71 61 79 28 11 64 92 19 36 74 50 8 27 20 19 63 48 64 63 94 10 20 41 16 24 7 9 20 96 91 17 81 20 88 54 9 51 68 92 51 84 69 13 50 25 28 75 92 5 10 71 79 24 48 57 95 3 45 98 68 14 54 48 31 81 55 75 64 
52 43 4 95 43 44 62 35 12 88 27 53 22 98 3 98 36 60 29 98 42 43 100 72 64 78 93 38 34 79 12 73 82 57 36 4 26 25 62 65 22 50 94 13 53 88 95 20 70 72 3 37 59 9 20 51 93 63 20 73 74 90 79 93 90 36 75 49 32 73 72 18 68 63 20 89 59 68 92 32 70 71 31 67 64 88 43 85 3 82 57 84 90 30 5 31 58 35 70 60 
73 65 91 4 7 11 51 12 68 32 27 34 79 81 99 53 13 95 30 36 94 37 60 94 9 13 35 50 35 29 12 41 70 63 11 51 81 42 92 70 18 90 99 88 79 59 7 100 20 5 23 19 71 90 51 47 51 28 1 23 31 26 75 98 55 76 42 32 52 33 8 28 25 82 36 96 51 62 78 57 2 33 72 83 27 49 25 26 60 34 36 41 90 61 7 83 3 16 8 55 
10 13 90 26 55 82 62 59 51 78 57 56 66 57 32 21 54 77 61 90 2 92 63 51 90 99 38 90 97 8 56 96 94 57 6 37 37 35 62 22 13 90 44 77 7 1 27 75 49 70 64 38 28 67 39 40 46 88 64 18 75 51 29 19 63 18 20 83 37 100 60 70 31 26 38 1 1 23 80 92 57 99 19 96 17 50 19 45 84 75 9 62 23 46 14 64 70 86 14 80 
44 5 44 14 94 89 2 11 72 35 8 99 60 79 32 65 6 57 72 58 35 85 51 77 9 35 90 23 88 37 43 68 82 31 14 8 89 13 18 56 2 42 29 64 54 5 87 73 20 47 22 78 13 66 64 34 38 21 54 65 61 25 76 97 80 61 49 77 92 62 48 19 28 68 54 18 24 60 32 97 100 65 70 77 92 1 94 33 48 23 61 71 93 97 96 31 66 8 18 77 
87 15 29 76 49 6 13 75 7 75 57 61 6 39 68 32 44 60 79 89 23 71 6 84 24 44 1 77 40 71 79 19 51 46 75 60 31 70 4 54 55 47 43 12 87 29 83 15 75 24 10 62 3 38 28 50 83 99 73 28 86 76 26 94 42 35 73 89 32 19 60 91 10 35 69 1 42 23 84 93 53 71 80 33 20 94 48 27 84 84 100 40 17 19 57 96 78 53 34 69 
