jobs 100
stage 8
machines 5 5 5 5 5 5 5 5 
*Pro_req*
1 2 2 2 2 2 3 3 3 1 2 5 2 5 1 1 4 5 4 2 4 1 4 4 2 5 4 1 2 4 2 1 4 1 3 5 4 3 1 5 3 4 1 5 5 1 4 3 2 5 3 5 2 4 5 4 2 5 1 1 5 3 1 1 3 5 1 4 5 1 4 2 2 3 5 3 5 1 2 3 4 4 3 1 3 2 2 2 1 4 5 4 2 5 5 1 5 1 4 3 
1 2 3 4 5 4 2 5 4 3 4 4 3 3 1 5 2 3 5 5 4 2 1 1 5 3 5 1 3 1 5 5 4 4 2 1 4 1 4 3 5 5 5 5 4 5 5 5 3 4 3 1 5 3 4 2 2 5 2 2 3 5 1 1 4 1 4 3 5 2 2 2 2 2 3 1 3 3 3 5 4 5 4 1 3 2 2 5 2 4 4 5 4 3 4 5 2 3 3 5 
5 4 2 3 5 3 1 3 5 4 4 3 5 5 4 2 1 5 3 4 4 5 5 3 4 1 2 5 5 3 2 3 5 1 5 2 4 4 4 3 1 5 4 2 1 1 2 1 5 2 1 3 2 3 2 2 3 5 2 5 1 4 3 1 3 5 1 1 3 5 1 5 4 1 2 3 5 1 5 1 1 3 5 1 5 4 4 5 3 4 2 5 4 4 2 1 5 3 1 2 
2 4 3 4 3 5 5 2 1 3 5 5 3 1 5 4 2 1 2 1 4 2 3 2 4 3 3 1 1 1 1 3 1 5 3 5 2 5 1 4 2 5 5 1 4 3 5 5 3 1 2 4 2 4 4 2 1 4 5 1 3 1 4 1 2 3 5 4 3 4 2 2 3 2 4 2 1 2 1 1 3 2 3 5 4 1 4 2 1 1 2 4 4 1 1 1 3 4 5 2 
2 2 2 1 3 3 2 3 2 2 4 3 5 3 3 4 3 2 2 1 3 1 5 5 5 1 1 2 1 2 5 2 1 4 4 1 1 5 5 2 5 3 2 2 3 1 1 4 2 1 2 5 1 1 1 4 2 1 1 2 2 1 5 4 4 4 1 3 4 2 1 3 5 2 4 3 4 3 5 2 2 4 2 2 5 1 4 2 4 4 5 2 4 4 2 3 2 2 4 1 
1 4 5 1 1 4 1 4 2 1 2 2 5 1 1 3 5 3 4 1 1 2 1 1 2 3 1 1 5 5 5 2 1 1 5 2 5 3 2 3 1 5 1 2 3 3 3 2 5 4 1 4 4 3 4 1 1 2 2 5 2 4 3 2 3 4 5 3 5 5 4 4 2 1 2 4 4 1 4 5 1 5 1 5 2 3 5 2 5 3 4 5 5 3 1 1 1 1 2 5 
5 3 1 3 1 5 3 4 1 5 4 3 4 1 3 1 4 1 3 2 5 3 4 4 1 2 2 2 5 2 5 2 4 4 1 3 3 1 1 4 1 1 1 3 1 4 3 5 1 5 1 5 1 3 2 4 4 5 4 4 3 4 2 4 1 1 1 4 1 4 1 3 1 5 5 5 5 5 1 1 1 1 4 1 4 1 3 4 1 4 3 5 2 3 3 2 5 3 3 3 
4 2 3 3 4 4 3 3 1 5 3 3 5 1 2 2 4 4 2 5 3 1 2 5 1 3 2 3 5 4 2 3 1 5 5 5 1 4 1 5 1 3 4 4 1 4 4 3 2 1 3 3 2 3 2 4 4 1 2 1 3 5 2 1 4 5 2 4 3 3 3 3 3 2 3 3 3 3 3 4 5 3 4 2 3 4 5 4 3 1 4 1 2 2 5 2 5 5 2 5 
*Pro_time*
51 77 61 78 29 99 5 28 83 47 79 7 80 15 28 51 15 44 63 30 80 12 100 90 11 57 32 82 8 10 83 50 15 36 73 38 91 16 4 41 92 49 53 86 1 86 77 89 54 1 48 71 56 77 94 51 33 6 62 69 91 8 53 14 64 90 38 49 69 79 5 9 61 9 1 78 9 72 35 40 78 79 30 33 53 69 5 28 68 32 30 15 19 64 39 25 47 40 98 84 
24 58 66 74 80 43 44 99 40 91 54 38 67 100 44 88 88 2 26 17 1 23 9 41 68 8 99 3 96 8 31 55 61 32 75 67 1 7 5 64 70 7 9 61 87 32 100 51 87 64 89 84 10 32 51 6 28 6 2 92 60 56 62 6 82 29 18 63 14 55 19 32 49 52 87 1 72 82 71 64 40 92 91 66 19 37 25 39 78 97 58 57 65 37 92 52 26 32 27 68 
66 22 2 35 52 82 29 90 87 91 94 13 58 93 92 36 72 80 21 23 21 69 74 40 45 46 28 19 23 43 15 22 39 19 42 58 65 82 87 28 28 35 8 42 27 26 17 44 90 7 82 31 34 85 91 64 84 19 28 21 9 57 1 98 11 10 92 93 57 13 63 40 88 47 34 89 90 44 58 19 37 38 30 32 73 27 65 87 69 1 70 15 20 7 54 81 21 7 96 56 
69 56 67 24 68 18 77 37 92 74 64 2 61 7 4 89 65 1 15 96 12 70 61 55 100 84 95 49 66 97 96 97 59 50 54 42 22 50 44 49 30 88 24 46 41 16 53 26 48 41 15 68 21 33 63 1 97 21 3 38 66 3 75 96 76 37 39 19 35 91 62 1 57 83 64 23 61 11 6 100 26 64 12 6 51 84 8 82 4 53 69 51 72 74 35 42 3 22 75 84 
82 25 73 35 64 6 61 36 46 70 93 82 68 3 53 76 14 53 72 65 77 99 69 92 25 79 15 53 53 77 11 90 17 32 99 47 5 63 11 52 54 69 35 22 8 81 35 23 78 70 36 93 92 45 52 33 77 100 41 40 29 17 21 95 32 86 25 73 36 80 43 2 56 40 91 15 70 92 99 36 79 62 41 78 55 73 53 21 31 65 1 21 2 86 15 41 60 82 54 55 
91 7 61 96 90 45 83 95 60 50 2 10 41 8 3 4 46 52 96 99 58 82 14 82 25 27 87 92 81 79 93 94 40 21 74 25 73 10 84 57 1 87 29 37 40 85 60 58 40 34 39 30 50 27 41 81 67 14 8 22 98 15 7 4 92 22 65 70 45 91 26 94 86 44 100 19 83 60 91 33 27 55 50 23 42 25 66 52 61 7 83 27 22 23 3 42 85 41 48 36 
66 50 20 93 80 66 4 100 70 45 60 81 62 82 73 34 38 1 99 69 93 74 3 57 37 64 6 26 72 4 62 25 24 21 42 21 47 14 86 31 75 17 72 87 85 89 32 94 71 22 74 40 46 9 96 97 69 89 77 89 58 54 65 87 78 60 55 21 54 67 4 87 68 44 33 6 38 41 13 35 79 24 51 66 19 78 53 95 89 84 93 27 19 8 77 77 8 71 13 61 
51 29 79 19 46 82 5 49 3 36 91 48 67 20 87 2 58 41 7 4 4 94 53 17 17 85 82 39 99 71 89 50 64 31 69 98 89 85 18 57 75 14 28 1 86 23 31 27 27 94 83 60 64 94 86 34 32 72 55 61 24 21 56 40 83 1 16 63 32 28 18 76 43 17 14 32 82 20 94 75 85 54 24 82 62 73 56 26 16 3 30 13 40 73 36 7 33 63 80 17 
