jobs 100
stage 8
machines 5 5 5 5 5 5 5 5 
*Pro_req*
3 4 1 2 3 5 4 5 1 1 4 1 2 4 5 2 3 2 3 1 1 3 3 3 1 1 1 2 4 5 5 2 2 1 2 3 2 5 3 1 3 4 2 3 4 2 3 3 1 5 3 1 1 4 4 4 2 1 3 5 2 2 4 4 3 1 3 5 3 1 5 4 5 5 5 3 5 4 3 3 3 2 1 5 5 3 2 3 5 2 1 1 2 1 2 3 4 5 5 1 
1 1 3 2 3 4 1 5 4 2 3 1 2 5 3 2 3 2 2 2 3 3 2 5 1 5 4 2 3 5 1 1 1 1 1 4 3 1 1 3 1 1 1 3 5 3 3 1 4 3 4 3 5 4 4 1 5 1 4 2 1 3 5 2 4 2 2 4 1 5 4 2 4 5 4 3 1 1 3 3 5 1 5 4 1 1 2 3 1 1 4 3 4 4 5 2 1 3 2 5 
1 3 3 4 4 5 1 5 4 3 2 4 1 1 2 1 3 5 5 5 1 4 1 5 3 5 2 3 2 4 4 2 5 4 1 5 4 3 2 5 2 2 4 1 4 3 2 5 2 2 4 1 1 3 5 3 4 5 1 5 2 4 1 5 3 4 3 2 5 5 3 3 1 4 5 1 4 2 2 5 5 5 2 1 1 1 4 5 5 2 5 3 3 2 5 1 3 2 4 5 
5 5 3 2 1 1 1 2 2 1 1 2 4 1 2 1 5 4 5 1 5 2 2 3 4 3 3 2 4 5 5 4 2 4 4 5 5 3 1 3 4 1 2 2 5 4 1 3 5 2 3 3 3 3 4 4 2 3 1 4 5 1 5 3 1 3 3 3 4 5 2 3 3 5 4 3 2 1 5 1 1 2 4 1 2 2 4 3 3 5 2 2 3 5 3 2 1 2 1 1 
4 4 2 5 5 4 1 5 3 2 3 2 1 5 3 2 1 5 3 3 5 2 4 2 5 5 5 5 3 2 1 4 5 3 1 2 4 4 3 1 5 1 2 1 2 3 2 2 4 1 3 3 4 5 5 3 4 3 4 1 4 4 2 5 5 5 3 1 2 2 5 3 4 3 3 5 3 5 3 5 1 5 1 1 1 2 2 3 5 1 2 5 3 3 1 3 2 4 4 2 
1 4 1 5 2 3 5 4 5 3 4 2 2 1 3 4 1 2 2 5 1 2 4 3 4 3 1 1 5 2 5 3 3 2 2 3 2 1 5 5 4 1 4 3 4 2 1 1 3 4 4 3 3 1 3 5 4 3 5 4 4 3 1 4 5 4 5 2 1 1 5 3 5 4 4 2 5 3 4 5 5 4 1 4 1 5 1 5 2 2 3 1 1 1 1 4 2 2 5 4 
1 1 5 1 4 2 1 5 5 5 4 2 1 1 5 5 5 1 2 4 1 1 4 1 2 2 2 2 1 3 3 4 3 3 1 1 1 2 4 3 4 2 4 5 1 5 5 2 5 3 4 2 3 2 3 3 4 4 4 2 5 4 2 2 2 3 2 5 4 2 1 2 3 2 2 1 2 2 5 1 2 5 1 3 5 2 2 3 3 1 4 3 4 4 1 5 4 3 1 2 
2 2 5 5 1 1 5 5 4 5 5 4 2 2 4 5 1 1 3 4 3 3 3 1 3 1 4 5 1 4 4 2 4 2 1 4 4 3 3 2 3 5 4 2 1 2 5 1 1 4 2 5 3 3 5 3 5 4 3 1 4 2 2 4 1 3 5 4 5 3 1 5 3 5 4 3 3 4 5 3 5 3 1 4 2 5 3 4 3 5 1 3 1 4 5 5 1 4 3 3 
*Pro_time*
11 24 58 19 90 53 92 95 85 64 34 80 82 78 19 86 21 58 68 57 20 73 95 59 57 42 35 13 61 21 73 36 52 56 83 88 79 67 95 8 100 98 69 19 33 51 60 5 93 13 83 92 4 16 76 71 81 41 61 71 50 7 5 70 72 49 24 35 49 32 59 50 76 94 15 40 53 93 63 45 37 72 29 5 85 7 80 63 43 93 15 40 51 55 52 17 38 13 89 47 
42 26 30 74 7 77 71 87 3 5 8 35 83 43 59 44 87 40 28 13 31 22 79 81 63 83 9 7 38 5 76 65 99 29 24 61 15 71 60 47 52 54 71 31 21 83 28 44 92 59 93 28 57 38 51 52 2 66 97 52 66 11 33 7 9 53 51 3 51 35 8 31 96 97 58 63 61 72 75 2 59 79 91 22 52 52 62 95 54 71 4 1 95 14 61 36 92 70 87 98 
89 95 4 55 83 19 47 38 32 79 24 73 95 90 98 74 8 55 58 33 66 41 77 30 60 11 89 71 95 4 37 62 19 30 46 60 59 30 75 18 85 54 24 50 18 70 17 58 87 52 19 94 71 90 3 52 48 51 79 24 76 25 58 95 72 37 9 40 63 2 29 53 6 10 96 19 75 1 94 11 80 71 33 63 21 24 85 35 8 28 27 59 85 98 90 11 60 50 84 22 
79 16 4 42 74 96 75 81 94 60 56 20 62 55 91 100 70 66 67 74 46 38 26 24 5 13 33 37 28 72 94 68 39 33 57 96 52 35 45 33 96 93 98 91 78 25 47 71 71 13 99 54 37 46 88 35 44 43 88 87 57 95 75 47 68 93 6 74 37 2 55 32 55 10 48 32 72 78 37 6 73 3 96 54 38 33 70 46 44 38 47 81 7 26 5 15 17 61 95 75 
12 95 94 54 68 71 82 35 60 10 76 17 16 36 20 75 60 88 3 74 48 28 83 40 69 87 78 56 59 58 92 76 42 97 58 90 18 26 57 42 47 5 87 85 71 63 12 95 3 55 98 20 14 21 43 99 36 95 87 100 88 21 39 39 15 100 28 31 96 38 85 33 45 70 26 30 59 78 13 13 65 64 82 92 79 93 29 54 59 37 68 12 31 82 50 98 11 82 74 53 
46 48 44 10 6 41 53 52 69 97 74 23 74 93 26 93 81 93 39 53 34 98 57 42 10 66 12 52 87 89 44 100 17 84 31 43 26 70 7 44 38 22 92 28 89 62 88 71 76 32 99 77 52 10 77 31 27 55 84 18 23 83 78 48 88 78 99 75 32 21 3 45 16 77 26 13 28 23 52 75 30 43 92 29 24 96 16 13 68 91 46 25 73 57 41 20 24 65 54 10 
22 46 81 71 88 85 7 15 70 2 69 59 88 44 78 62 29 13 6 73 18 66 11 98 87 30 93 93 84 55 91 86 84 16 47 10 63 88 26 81 97 79 56 17 26 60 57 70 8 85 87 30 81 10 92 50 1 11 17 80 57 10 42 86 63 25 96 41 18 97 60 38 63 91 83 17 48 89 64 95 37 71 58 49 87 100 82 34 56 9 40 42 99 37 92 77 11 74 84 62 
73 38 6 80 91 26 71 97 16 81 41 70 45 40 25 63 90 9 57 97 52 43 57 96 11 17 23 13 20 28 71 36 33 13 50 58 18 39 42 57 43 36 7 94 48 23 53 55 29 80 91 33 34 72 49 4 70 56 10 62 66 68 67 14 8 14 6 93 99 100 24 21 98 49 19 24 3 26 12 24 64 12 18 45 98 92 20 7 65 13 82 6 72 66 96 3 95 7 95 31 
