jobs 10
stage 5
machines 5 5 5 5 5 
*Pro_req*
3 4 4 5 2 3 1 2 4 5 
1 3 5 4 5 3 2 1 3 4 
1 4 2 3 2 4 1 4 4 3 
1 2 1 3 1 2 2 2 2 3 
1 3 5 3 3 5 3 4 5 5 
*Pro_time*
65 27 29 34 43 64 26 77 15 12 
28 89 26 62 92 50 80 87 6 75 
66 30 11 24 31 93 62 59 13 57 
71 70 68 57 7 100 43 13 22 55 
56 70 54 35 94 63 7 26 7 6 
