jobs 10
stage 5
machines 5 5 5 5 5 
*Pro_req*
5 4 3 4 1 4 4 1 4 2 
3 1 2 3 3 2 3 4 2 1 
3 3 1 5 2 3 3 1 1 1 
3 1 3 2 3 3 2 1 1 3 
3 5 5 1 5 3 5 5 5 1 
*Pro_time*
54 40 59 21 90 17 60 96 97 34 
73 80 80 17 72 67 6 53 40 12 
70 65 82 63 43 48 7 6 4 11 
10 93 74 78 57 91 10 67 25 95 
43 33 83 89 11 96 56 78 65 68 
