jobs 10
stage 5
machines 5 5 5 5 5 
*Pro_req*
5 5 2 5 4 4 3 2 3 4 
4 2 3 5 2 4 1 1 4 2 
1 2 1 5 5 2 4 5 3 5 
3 2 3 5 1 5 3 1 1 3 
2 5 1 2 5 3 4 5 2 1 
*Pro_time*
95 70 79 6 72 70 65 23 86 3 
8 44 28 96 54 53 97 4 44 70 
4 97 73 97 25 77 81 56 28 56 
57 30 7 73 96 66 46 93 72 51 
29 5 10 16 13 14 100 61 5 56 
