jobs 10
stage 5
machines 5 5 5 5 5 
*Pro_req*
3 4 1 2 3 5 4 5 1 1 
1 3 3 3 1 1 1 2 4 5 
3 4 2 3 4 2 3 3 1 5 
2 2 4 4 3 1 3 5 3 1 
3 2 1 5 5 3 2 3 5 2 
*Pro_time*
68 10 34 75 91 32 49 21 58 2 
100 22 25 16 38 52 25 84 56 12 
43 8 4 67 63 62 35 11 46 87 
85 64 89 86 85 46 83 71 55 49 
12 6 24 10 36 42 78 97 94 13 
