jobs 10
stage 5
machines 5 5 5 5 5 
*Pro_req*
3 5 2 3 1 3 1 4 3 5 
4 3 3 2 3 4 1 5 1 2 
2 5 5 2 2 5 1 4 3 4 
2 5 3 2 1 5 5 5 1 5 
5 3 4 4 3 2 3 4 3 3 
*Pro_time*
3 87 83 77 80 94 20 47 54 10 
88 58 89 34 64 34 66 20 37 16 
89 69 83 77 12 3 88 26 29 15 
13 36 27 17 62 24 19 46 72 86 
34 1 64 68 84 16 12 27 66 61 
