jobs 10
stage 5
machines 5 5 5 5 5 
*Pro_req*
1 4 1 4 3 4 5 3 1 3 
3 3 4 2 2 3 4 1 5 3 
5 1 5 5 4 3 5 4 1 1 
1 2 1 1 2 5 2 1 5 2 
4 5 4 4 3 2 5 5 1 3 
*Pro_time*
100 35 46 41 84 24 88 52 8 75 
80 27 84 92 24 11 99 47 96 19 
4 78 72 9 57 49 72 70 40 6 
46 55 86 56 82 79 43 10 70 10 
40 12 80 32 74 51 91 80 93 63 
