jobs 10
stage 5
machines 5 5 5 5 5 
*Pro_req*
3 1 2 2 1 1 3 1 4 4 
2 1 2 5 5 3 2 4 5 1 
3 2 3 5 5 1 3 5 3 3 
2 5 2 4 3 1 5 2 1 3 
2 4 2 3 2 3 3 1 3 2 
*Pro_time*
49 56 94 67 20 9 17 81 11 40 
77 52 60 100 71 59 37 28 54 98 
96 100 100 87 16 68 67 52 79 23 
96 10 71 71 67 8 99 7 37 85 
54 85 2 21 81 10 89 60 78 20 
