jobs 10
stage 5
machines 5 5 5 5 5 
*Pro_req*
1 2 3 4 3 4 4 1 4 3 
3 3 2 2 2 3 3 5 5 5 
3 5 3 2 4 4 2 5 1 1 
3 3 5 1 3 2 5 3 4 5 
4 1 1 5 1 5 4 3 2 2 
*Pro_time*
19 49 29 15 13 92 74 29 50 64 
9 6 94 81 67 9 60 83 98 22 
57 23 38 48 83 26 99 5 24 82 
18 48 95 70 11 100 50 57 3 19 
100 24 32 45 70 42 19 67 28 17 
