jobs 10
stage 5
machines 5 5 5 5 5 
*Pro_req*
4 2 2 5 2 5 1 1 4 5 
2 5 4 1 3 4 3 5 2 4 
1 2 3 3 3 5 3 3 3 1 
5 1 5 5 2 2 1 2 1 5 
5 3 1 4 4 3 3 1 2 2 
*Pro_time*
35 85 6 80 65 29 3 70 56 32 
46 9 99 47 42 20 25 40 81 52 
51 16 88 66 44 52 97 69 85 51 
53 48 3 99 65 100 83 100 35 18 
6 9 93 85 7 44 23 63 31 94 
