jobs 50
stage 8
machines 2 1 2 2 5 5 5 5 
*Pro_req*
1 1 2 2 2 1 2 1 1 2 2 1 1 1 2 1 1 1 2 2 1 1 2 1 2 1 2 2 1 2 2 2 1 2 2 1 2 1 1 1 2 1 1 2 1 1 1 2 1 1 
1 1 1 1 1 1 1 1 1 1 1 1 1 1 1 1 1 1 1 1 1 1 1 1 1 1 1 1 1 1 1 1 1 1 1 1 1 1 1 1 1 1 1 1 1 1 1 1 1 1 
2 1 2 1 2 1 2 2 1 1 1 2 2 2 2 2 1 1 1 2 2 1 1 1 2 2 2 1 1 1 1 1 2 1 2 1 1 1 2 2 2 1 1 2 2 1 1 2 1 1 
2 1 1 1 1 1 1 1 1 1 2 1 2 1 1 2 2 1 2 2 2 1 2 2 2 2 2 1 2 2 2 2 2 1 1 1 1 2 2 1 2 1 2 1 2 1 1 1 2 2 
5 4 3 3 3 4 3 1 1 1 3 3 1 4 5 3 5 3 3 1 4 4 4 2 3 3 3 1 2 3 4 1 1 5 3 2 1 4 4 2 5 3 3 3 2 4 2 5 2 4 
5 4 5 4 3 5 1 3 2 5 4 4 2 4 3 1 5 4 3 4 4 5 3 4 2 2 2 5 4 5 2 5 4 5 4 1 5 3 5 1 4 4 5 1 3 1 5 5 5 4 
2 3 5 2 5 4 4 4 4 1 5 5 2 1 2 2 2 4 2 1 3 5 4 4 1 2 1 4 3 3 4 3 2 2 3 5 4 5 1 2 2 2 1 3 2 5 5 4 2 2 
3 3 4 4 4 1 1 2 1 3 3 2 2 4 3 4 3 2 2 1 3 1 3 5 5 5 5 4 3 1 2 3 1 3 3 4 1 1 2 4 5 2 5 2 2 3 4 3 1 5 
*Pro_time*
75 69 75 72 5 87 24 2 91 80 6 62 84 92 44 70 52 3 34 86 98 94 67 23 91 95 98 32 32 14 9 54 62 1 76 83 74 82 37 33 58 40 29 1 94 12 20 80 41 16 
16 3 39 64 14 61 29 14 38 46 64 48 82 30 41 39 34 59 27 45 65 89 36 75 59 12 49 41 68 30 79 10 47 83 88 80 61 5 68 22 71 63 24 66 4 33 81 76 37 95 
13 59 11 87 96 11 83 2 60 22 1 78 92 31 15 41 89 79 77 4 37 38 90 97 15 86 32 67 36 43 98 54 24 50 3 99 20 69 31 59 12 13 28 44 8 96 51 66 73 63 
46 31 8 11 2 16 47 5 76 50 5 16 36 52 5 21 31 59 16 18 17 37 3 95 50 47 86 9 8 75 43 28 15 87 50 33 60 79 6 92 77 60 2 53 43 20 79 6 51 69 
97 18 67 87 6 22 3 43 4 14 32 35 46 63 27 34 55 82 79 87 88 76 13 22 78 49 24 55 54 86 38 86 54 36 16 91 87 36 38 48 99 34 22 11 25 97 3 30 74 18 
67 38 8 70 53 74 14 97 73 43 19 80 11 45 45 58 78 100 79 52 53 93 21 13 52 59 49 31 44 21 84 6 38 45 74 1 66 36 66 29 97 28 53 97 77 37 39 46 78 67 
25 85 96 69 49 52 19 47 13 50 69 75 4 95 36 25 9 7 78 16 65 16 57 51 22 29 74 34 83 14 8 15 91 77 97 56 10 98 71 63 40 3 11 95 98 53 75 26 97 63 
87 34 21 31 75 52 33 85 40 94 63 90 47 59 33 67 30 77 60 69 18 88 9 98 32 70 63 93 9 81 89 21 9 96 18 13 95 36 19 42 21 11 60 16 3 87 78 55 37 59 
