jobs 50
stage 8
machines 2 3 4 3 4 2 3 5 
*Pro_req*
1 1 2 1 2 1 1 2 2 2 1 1 2 2 1 1 1 2 1 1 1 2 2 2 2 2 2 1 2 1 1 1 2 2 2 1 2 1 1 1 1 1 2 1 2 2 1 2 2 2 
2 3 1 1 2 3 1 3 3 2 1 1 1 3 1 3 3 1 1 3 1 2 1 1 3 1 3 3 1 3 2 2 3 2 1 1 1 1 3 1 3 1 2 3 2 2 3 1 2 2 
2 1 1 4 2 3 1 4 3 4 1 2 2 2 1 4 2 2 4 2 2 2 1 2 4 4 1 2 3 4 2 3 3 1 1 1 2 1 4 2 1 2 2 2 4 1 2 3 2 1 
2 2 2 2 2 3 1 2 2 1 3 1 2 1 3 2 1 3 1 2 3 1 2 1 2 1 1 1 1 1 2 1 2 3 2 2 3 2 1 2 3 3 3 2 1 1 1 2 2 1 
1 4 3 4 1 4 3 4 4 2 1 4 1 1 1 4 1 3 1 2 3 4 3 2 4 2 2 3 3 1 3 3 4 2 4 4 3 4 3 2 3 2 3 3 4 1 3 2 4 1 
2 1 2 2 2 1 2 2 2 1 2 1 2 1 2 1 2 1 1 1 1 1 2 1 2 2 1 1 2 2 2 1 1 2 2 2 1 1 1 1 1 1 1 1 2 2 1 1 1 2 
2 2 2 1 3 2 3 1 3 2 2 2 1 2 1 1 3 1 2 3 3 3 3 2 1 1 1 1 3 3 3 1 1 3 2 2 2 1 1 1 1 3 1 2 3 1 2 1 1 2 
5 5 3 3 1 1 1 5 5 5 5 2 5 2 5 3 3 1 3 1 3 1 4 2 3 3 3 2 2 3 2 2 5 3 4 3 2 2 3 1 1 1 4 3 2 5 5 2 2 5 
*Pro_time*
73 38 73 73 93 84 84 29 53 97 25 43 77 89 58 64 45 95 78 6 11 50 44 32 73 32 23 55 23 100 37 36 50 58 99 4 39 59 12 92 72 65 68 67 3 92 59 98 82 52 
37 38 89 50 57 56 57 25 56 78 86 82 5 50 99 1 18 47 30 63 36 71 23 69 15 49 30 12 93 42 28 85 34 34 40 83 62 61 99 8 14 65 45 14 73 13 7 86 62 80 
81 73 91 87 15 61 60 85 18 60 45 77 85 18 70 33 20 40 78 71 87 15 81 58 33 77 14 63 8 2 31 11 28 74 83 74 25 71 36 89 58 71 74 98 80 84 2 18 18 26 
69 44 21 70 30 13 23 94 78 84 30 12 88 83 38 58 93 20 1 22 50 41 44 15 76 16 58 11 14 16 37 19 71 71 44 41 92 30 69 69 96 59 78 77 27 92 69 48 99 27 
84 48 41 72 1 32 42 44 75 85 58 77 100 39 43 19 66 95 14 13 38 89 72 8 79 88 62 33 46 58 40 53 23 18 14 75 65 66 67 48 42 88 91 63 56 88 32 95 38 93 
4 24 8 77 18 80 17 57 9 34 33 26 89 36 15 32 77 76 89 97 36 32 91 26 98 22 93 1 98 86 61 28 15 28 12 26 78 4 95 93 10 83 15 41 36 7 61 69 63 31 
97 33 100 5 42 60 37 37 97 10 48 69 78 71 17 27 73 34 33 59 51 36 17 83 57 93 14 91 40 3 92 81 55 92 44 67 27 57 44 41 93 47 57 53 12 38 52 3 37 80 
99 25 81 40 17 47 36 10 86 93 100 15 29 76 29 25 43 70 88 5 35 27 69 53 2 17 51 56 12 44 18 53 55 13 13 33 34 58 32 33 1 86 93 30 20 30 26 36 56 49 
