jobs 50
stage 8
machines 1 4 5 4 4 4 1 2 
*Pro_req*
1 1 1 1 1 1 1 1 1 1 1 1 1 1 1 1 1 1 1 1 1 1 1 1 1 1 1 1 1 1 1 1 1 1 1 1 1 1 1 1 1 1 1 1 1 1 1 1 1 1 
2 1 1 2 1 3 1 4 2 3 4 3 4 3 3 4 1 3 2 3 4 1 3 3 4 1 4 3 3 2 4 1 3 3 1 1 1 4 4 2 4 4 3 2 4 1 2 1 2 3 
2 1 5 1 1 1 1 5 3 5 3 5 1 5 1 3 5 3 2 2 3 5 1 3 4 1 3 4 5 2 2 3 3 4 2 4 4 4 5 4 4 3 3 4 5 2 1 3 3 5 
4 2 2 1 2 4 3 4 3 4 2 2 3 1 4 1 2 2 1 2 1 2 1 1 2 3 4 3 4 1 2 3 3 3 2 4 2 2 3 2 4 4 3 1 3 2 2 3 3 2 
4 4 2 4 4 4 3 4 3 2 3 4 1 2 2 1 3 2 2 4 1 1 3 1 3 3 2 4 3 2 2 4 1 1 1 4 3 1 4 3 4 3 3 4 2 4 3 3 1 1 
1 1 3 2 3 2 1 2 1 2 4 1 1 2 1 1 3 1 2 3 3 3 2 4 4 2 1 1 1 4 3 4 1 3 3 1 1 4 1 4 3 3 1 3 3 2 4 2 4 1 
1 1 1 1 1 1 1 1 1 1 1 1 1 1 1 1 1 1 1 1 1 1 1 1 1 1 1 1 1 1 1 1 1 1 1 1 1 1 1 1 1 1 1 1 1 1 1 1 1 1 
2 1 2 2 1 1 1 1 2 1 2 2 1 1 2 2 2 2 2 1 1 1 1 1 1 2 2 1 1 2 2 1 1 2 1 1 1 1 1 2 2 1 1 2 2 2 2 1 2 2 
*Pro_time*
37 74 87 80 6 67 66 96 63 98 47 24 84 61 58 60 12 26 36 20 81 12 55 99 21 94 47 95 53 47 7 14 98 94 2 3 4 83 37 89 99 18 23 9 70 52 14 22 57 89 
26 72 99 38 55 76 27 81 4 24 100 91 34 46 47 5 72 70 60 96 77 80 95 37 51 93 13 3 39 90 30 61 39 49 31 35 42 33 70 16 27 48 71 80 83 16 8 24 58 10 
11 14 27 93 55 29 67 45 95 85 97 11 87 58 44 90 57 83 22 80 38 84 99 1 1 82 51 69 25 9 68 48 78 58 53 81 67 81 33 96 84 90 72 21 73 97 88 88 52 2 
99 96 31 30 10 71 20 12 62 14 23 49 78 100 58 2 86 55 71 67 96 84 58 29 50 22 9 54 11 9 52 1 74 49 98 43 28 89 20 18 83 99 51 74 76 44 99 45 89 27 
44 21 99 87 40 18 35 35 78 2 72 13 42 25 78 57 24 51 52 98 67 52 79 40 37 9 26 41 19 85 84 35 79 82 71 7 79 19 47 22 100 12 76 37 95 10 1 64 31 49 
36 14 55 82 100 4 11 51 88 9 96 73 60 44 72 92 6 50 38 10 59 68 78 62 12 43 77 83 1 70 49 10 86 33 62 44 49 89 28 36 41 1 58 65 73 36 41 90 60 4 
74 5 71 59 45 59 65 33 47 76 65 6 66 58 34 45 46 43 42 90 76 78 29 9 91 19 27 24 91 63 26 10 33 9 49 49 98 41 46 97 33 35 7 36 66 8 77 53 35 65 
70 66 76 51 18 25 70 53 1 59 4 37 93 42 43 42 91 81 43 88 34 45 72 53 30 48 91 39 18 83 91 37 67 5 54 40 21 58 41 31 6 66 92 72 88 95 76 44 80 17 
