jobs 50
stage 8
machines 2 1 2 3 2 2 5 4 
*Pro_req*
2 1 1 1 1 2 1 2 2 2 2 2 1 2 1 2 1 2 1 1 1 1 1 2 2 1 2 2 1 1 1 1 2 1 2 2 1 1 2 1 1 1 1 1 2 2 2 2 1 1 
1 1 1 1 1 1 1 1 1 1 1 1 1 1 1 1 1 1 1 1 1 1 1 1 1 1 1 1 1 1 1 1 1 1 1 1 1 1 1 1 1 1 1 1 1 1 1 1 1 1 
2 2 1 1 1 1 2 2 2 2 2 1 2 2 1 1 2 2 1 2 1 1 2 2 2 2 2 2 2 1 1 1 1 2 1 2 1 1 1 1 1 1 1 1 2 2 2 2 2 1 
1 1 1 1 3 3 3 1 2 3 3 3 3 1 2 3 3 2 2 3 1 3 1 1 3 2 3 3 3 3 1 3 3 3 1 1 2 2 2 2 3 3 2 3 2 3 2 1 2 2 
2 2 2 1 1 2 2 2 1 1 1 2 2 1 2 1 2 1 2 2 2 2 1 1 1 1 2 1 1 1 1 1 2 1 1 2 1 1 1 1 1 2 2 2 1 1 1 1 2 1 
1 2 1 2 1 1 2 1 2 2 1 1 1 1 2 1 1 1 1 2 2 2 2 2 2 1 1 2 1 1 1 1 2 2 2 1 1 2 2 1 2 1 2 1 2 1 2 1 1 2 
3 4 5 4 5 4 4 1 1 1 4 2 5 4 5 2 3 5 1 1 2 4 3 1 4 1 5 2 3 4 4 4 4 1 2 3 2 4 3 4 1 5 2 2 3 1 4 4 1 1 
3 4 1 4 2 1 2 4 3 4 1 1 1 1 4 2 3 3 2 4 3 1 2 1 4 3 4 3 1 2 1 1 3 3 2 4 4 1 1 3 2 2 4 4 1 4 3 2 3 4 
*Pro_time*
54 77 7 73 25 13 60 7 84 62 4 20 83 55 23 33 92 45 24 47 12 2 40 76 35 66 20 77 26 44 74 54 14 19 2 52 73 97 38 96 100 13 41 26 74 92 90 85 34 26 
2 25 45 9 11 28 31 17 28 95 44 24 78 82 73 48 5 34 20 45 65 55 26 54 87 6 57 95 45 15 25 34 12 41 57 67 21 74 61 52 31 83 3 72 36 85 6 60 63 23 
12 91 29 29 82 85 11 12 93 84 55 70 41 96 10 74 45 18 67 11 63 25 20 48 97 57 64 49 22 78 56 92 52 58 29 10 66 13 78 9 58 7 90 51 56 30 56 33 33 82 
92 71 63 64 41 30 80 16 30 13 40 37 38 25 35 93 25 33 69 34 76 53 38 90 92 39 33 11 22 51 79 85 61 4 97 52 98 32 90 80 19 58 72 39 8 57 42 13 21 68 
46 61 95 93 93 66 100 65 35 94 26 100 88 12 55 63 27 71 11 71 77 57 33 11 49 89 14 16 100 20 13 56 97 98 69 93 52 52 15 81 51 49 51 42 25 75 41 79 97 85 
46 42 3 98 75 21 78 20 99 76 22 42 22 27 51 89 37 21 4 53 70 39 63 28 1 41 35 52 76 69 75 24 50 24 7 43 66 94 5 83 68 33 28 53 83 70 61 66 41 45 
48 21 22 90 12 38 46 62 97 81 17 25 36 53 71 14 1 79 55 76 92 62 86 28 47 38 6 18 45 35 48 86 100 36 39 3 49 27 17 24 90 96 62 31 18 44 81 69 2 74 
5 61 23 85 33 76 51 70 30 92 46 1 9 27 79 64 59 84 26 65 23 79 14 18 92 79 81 23 9 12 23 46 49 44 5 18 65 77 21 1 29 32 60 65 67 5 20 30 35 64 
