jobs 50
stage 8
machines 1 1 3 1 3 2 4 1 
*Pro_req*
1 1 1 1 1 1 1 1 1 1 1 1 1 1 1 1 1 1 1 1 1 1 1 1 1 1 1 1 1 1 1 1 1 1 1 1 1 1 1 1 1 1 1 1 1 1 1 1 1 1 
1 1 1 1 1 1 1 1 1 1 1 1 1 1 1 1 1 1 1 1 1 1 1 1 1 1 1 1 1 1 1 1 1 1 1 1 1 1 1 1 1 1 1 1 1 1 1 1 1 1 
1 1 3 1 3 3 3 2 1 3 2 3 1 2 2 3 2 3 2 2 1 2 1 1 3 1 3 1 3 2 1 2 3 1 1 1 2 3 3 2 3 3 2 3 3 2 3 2 3 2 
1 1 1 1 1 1 1 1 1 1 1 1 1 1 1 1 1 1 1 1 1 1 1 1 1 1 1 1 1 1 1 1 1 1 1 1 1 1 1 1 1 1 1 1 1 1 1 1 1 1 
3 1 2 1 3 3 1 3 1 3 3 1 3 1 3 2 2 1 3 3 2 3 2 2 1 3 2 3 1 1 2 1 3 1 2 3 1 1 2 3 3 3 1 2 2 2 2 2 1 2 
1 2 2 1 2 1 2 2 2 2 2 1 2 1 2 1 2 2 2 1 2 1 2 2 2 1 1 2 2 1 2 1 2 2 1 2 1 1 1 2 2 1 1 1 1 2 2 1 2 1 
2 4 3 2 3 3 3 4 1 3 1 3 3 1 2 3 4 3 2 4 2 3 2 3 1 2 3 4 4 1 2 4 3 4 4 3 1 1 3 4 3 3 4 1 1 1 1 1 2 1 
1 1 1 1 1 1 1 1 1 1 1 1 1 1 1 1 1 1 1 1 1 1 1 1 1 1 1 1 1 1 1 1 1 1 1 1 1 1 1 1 1 1 1 1 1 1 1 1 1 1 
*Pro_time*
43 58 35 8 37 62 58 67 38 56 95 71 19 64 88 10 43 53 33 35 91 32 99 39 21 10 65 1 21 66 29 94 15 15 69 60 73 61 93 53 78 40 19 27 1 14 21 70 2 64 
44 87 58 88 79 12 47 14 51 84 45 96 86 37 50 58 15 78 34 32 37 85 46 9 57 48 84 100 100 94 67 1 68 65 17 24 2 38 33 14 49 92 3 100 57 80 62 29 87 42 
73 3 100 63 69 54 53 40 55 48 64 27 49 26 7 53 2 78 29 73 13 85 14 18 46 24 15 2 50 19 46 98 85 79 59 73 76 62 12 63 14 79 78 15 15 65 19 96 19 97 
49 73 45 22 49 41 3 77 44 28 30 70 67 12 84 75 31 41 11 5 2 91 83 61 5 75 1 6 78 22 84 11 70 68 53 59 100 93 62 46 76 58 56 95 54 40 20 22 12 13 
6 55 34 45 32 64 14 20 57 41 45 19 2 25 51 66 61 83 97 31 28 48 56 3 20 55 9 98 20 88 93 51 82 53 22 72 45 92 69 74 39 91 49 11 28 81 52 64 5 99 
63 4 75 66 75 7 59 8 54 66 71 96 49 43 14 46 30 71 10 67 58 52 31 37 26 95 35 32 4 77 84 86 20 89 15 34 90 75 83 60 61 12 28 17 93 57 13 17 11 71 
74 84 83 30 19 46 11 20 69 25 31 96 100 33 55 28 44 54 2 70 60 79 42 17 62 3 19 27 46 79 39 69 1 60 47 15 83 69 4 20 79 92 24 40 65 61 62 83 39 61 
38 16 31 11 74 25 82 64 75 80 38 24 9 58 19 31 61 80 48 69 27 84 12 90 81 31 28 46 62 19 72 75 6 93 61 54 85 81 1 14 83 50 32 90 48 56 45 53 82 92 
