jobs 50
stage 8
machines 2 1 2 5 2 3 2 3 
*Pro_req*
1 1 1 1 1 1 1 1 1 2 1 1 2 2 2 2 1 1 2 1 2 1 2 2 2 1 2 2 2 1 1 1 2 2 1 1 1 2 1 2 2 2 2 2 1 1 2 1 2 2 
1 1 1 1 1 1 1 1 1 1 1 1 1 1 1 1 1 1 1 1 1 1 1 1 1 1 1 1 1 1 1 1 1 1 1 1 1 1 1 1 1 1 1 1 1 1 1 1 1 1 
2 2 2 2 2 1 1 2 2 1 1 1 1 1 2 1 1 1 1 2 1 2 1 2 1 1 1 2 2 2 2 1 2 2 2 2 1 1 2 2 2 2 1 1 2 2 1 1 1 1 
4 4 4 4 1 1 5 3 5 2 2 4 1 5 4 1 3 4 5 1 5 5 1 2 1 2 1 1 4 5 3 4 5 3 3 3 2 4 2 4 2 5 5 5 1 1 3 3 4 5 
2 2 1 2 1 2 2 1 2 2 1 1 2 1 2 2 1 2 1 1 1 1 2 2 1 1 1 1 2 1 2 1 2 2 1 1 1 1 2 1 1 2 1 1 2 2 1 2 1 1 
2 3 1 2 1 1 1 1 1 2 2 2 3 1 2 3 1 3 3 3 2 3 2 3 3 3 1 3 2 2 3 2 2 2 1 1 1 2 2 3 3 1 1 1 1 3 3 1 3 2 
1 1 1 1 1 2 1 1 2 2 2 1 2 1 2 2 1 2 2 2 1 1 2 2 1 2 2 1 2 2 1 1 2 2 1 2 1 2 2 2 1 1 1 1 2 1 2 2 2 2 
1 1 3 3 2 2 2 3 1 3 1 2 1 1 2 3 1 1 2 3 1 3 1 2 1 3 3 2 1 1 1 2 3 2 3 2 2 3 2 1 1 3 2 3 1 3 2 2 2 1 
*Pro_time*
67 12 10 58 82 7 18 10 78 17 27 28 44 56 22 42 98 66 59 19 46 56 15 95 33 59 12 48 41 23 1 32 77 74 61 47 6 32 77 92 48 1 98 66 11 15 34 72 50 80 
47 77 4 67 14 75 35 41 25 41 44 65 9 67 38 28 91 83 100 87 80 25 64 13 19 79 51 73 6 45 88 76 31 25 2 45 3 37 85 1 71 54 43 83 69 46 47 92 71 6 
89 19 78 32 15 12 6 58 84 18 11 74 21 98 31 42 31 77 14 88 64 26 30 6 59 61 15 21 62 81 31 71 13 74 65 30 9 74 55 91 31 67 35 24 55 7 48 5 43 87 
77 91 85 9 3 91 44 31 54 95 79 53 61 70 10 68 53 91 83 63 24 58 62 49 42 99 47 16 77 47 67 49 99 48 86 49 73 34 16 53 44 35 28 100 19 31 37 13 87 71 
55 79 34 54 67 50 5 60 93 2 94 78 81 68 72 32 84 42 30 34 74 13 3 75 67 86 13 16 29 66 72 45 7 43 25 68 8 88 14 40 11 87 62 26 21 94 55 71 40 34 
93 52 67 91 87 13 46 78 5 52 96 55 5 17 28 54 76 48 98 15 81 15 95 20 19 81 55 65 93 91 85 5 14 5 99 62 91 62 45 63 79 98 46 27 61 64 41 21 63 11 
85 90 83 71 65 53 17 34 95 59 4 39 56 46 15 68 11 14 79 94 94 53 50 15 17 36 55 94 17 13 28 79 68 18 95 72 69 26 58 40 16 22 47 77 26 69 43 42 80 12 
52 84 82 86 2 30 51 69 7 76 25 22 95 1 22 12 77 40 59 12 74 23 78 57 75 21 11 98 10 71 35 98 78 81 53 58 80 2 40 47 17 69 7 31 44 90 76 47 3 38 
