jobs 20
stage 5
machines 5 5 5 5 5 
*Pro_req*
4 5 3 5 1 4 3 3 3 3 1 1 3 2 2 2 5 4 1 3 
1 1 4 2 3 3 2 2 2 2 3 3 2 5 5 5 5 2 2 1 
1 2 5 3 4 1 2 2 3 5 5 4 3 5 5 2 3 2 3 3 
3 1 1 1 2 5 1 3 3 2 3 5 5 4 4 1 3 1 3 5 
1 5 3 5 3 2 1 3 5 5 2 3 5 4 5 4 5 5 5 4 
*Pro_time*
45 96 5 16 43 98 21 30 62 40 19 66 33 9 21 17 79 50 14 65 
54 17 79 100 8 58 76 3 20 59 97 77 62 57 45 61 17 22 89 86 
13 89 95 46 83 16 21 70 6 10 66 53 17 72 89 46 84 30 35 63 
50 95 51 39 41 44 70 19 79 2 31 30 8 74 87 14 93 90 4 9 
39 95 86 9 13 15 67 91 98 14 49 32 81 34 31 78 31 54 42 11 
