jobs 20
stage 5
machines 5 5 5 5 5 
*Pro_req*
5 5 3 1 5 1 2 3 1 3 3 1 4 2 4 5 4 2 2 1 
2 5 3 1 1 2 4 2 1 3 4 1 5 4 3 5 1 1 1 2 
3 3 1 4 5 1 2 5 2 1 2 2 5 2 2 1 4 4 3 5 
5 4 3 5 1 5 1 2 4 2 4 5 1 3 3 3 2 1 3 2 
1 2 5 2 4 4 3 4 5 3 5 5 1 4 3 5 4 1 5 5 
*Pro_time*
71 66 18 94 12 66 24 36 41 29 84 34 93 65 25 86 69 6 93 94 
93 97 33 93 44 97 30 44 3 10 72 21 47 66 57 39 4 30 51 80 
50 98 8 50 35 27 42 67 31 93 72 18 59 53 49 14 81 91 60 75 
52 23 31 96 80 71 60 93 2 45 32 21 41 77 94 74 24 47 88 1 
41 99 92 43 98 79 21 4 34 58 33 92 84 33 57 83 79 38 6 41 
