jobs 20
stage 5
machines 5 5 5 5 5 
*Pro_req*
1 2 2 2 2 2 3 3 3 1 2 5 2 5 1 1 4 5 4 2 
3 4 1 5 5 1 4 3 2 5 3 5 2 4 5 4 2 5 1 1 
4 4 3 1 3 2 2 2 1 4 5 4 2 5 5 1 5 1 4 3 
4 1 5 5 1 3 2 5 1 1 5 3 1 2 4 2 5 1 1 3 
5 1 3 1 4 5 2 3 4 4 1 1 4 1 1 4 1 4 2 2 
*Pro_time*
71 1 75 69 32 85 65 11 35 72 24 18 61 13 41 87 79 58 7 81 
96 49 15 18 55 85 11 63 100 4 78 26 24 53 99 55 98 8 23 41 
51 77 61 78 29 99 5 28 83 47 79 7 80 15 28 51 15 44 63 30 
92 49 53 86 1 86 77 89 54 1 48 71 56 77 94 51 33 6 62 69 
78 79 30 33 53 69 5 28 68 32 30 15 19 64 39 25 47 40 98 84 
