jobs 20
stage 5
machines 5 5 5 5 5 
*Pro_req*
3 2 3 5 4 4 1 1 2 3 4 3 5 4 4 5 4 2 5 3 
2 3 2 3 2 3 3 2 2 5 4 1 3 1 1 1 4 4 1 3 
4 2 1 2 4 5 2 1 5 5 2 2 1 5 4 3 3 5 3 3 
3 5 4 5 1 4 3 2 1 4 2 4 3 2 1 4 2 5 3 2 
4 3 3 3 3 3 2 5 2 4 4 1 4 4 3 4 3 3 2 5 
*Pro_time*
69 88 92 9 89 67 46 40 26 96 92 35 20 79 69 90 41 71 70 10 
20 16 29 97 11 3 24 12 90 29 73 67 46 96 37 50 21 44 99 98 
68 89 73 48 82 29 44 94 4 46 62 70 42 75 60 88 4 59 90 17 
80 98 44 4 31 5 96 79 43 59 97 75 72 23 39 39 86 25 36 33 
25 88 8 74 3 54 49 92 16 39 12 43 29 85 27 12 85 48 54 83 
