jobs 20
stage 5
machines 5 5 5 5 5 
*Pro_req*
1 2 3 4 3 4 4 1 4 3 1 3 2 1 1 5 4 2 3 4 
3 5 3 2 4 4 2 5 1 1 3 2 2 3 5 2 5 1 2 5 
4 1 1 5 1 5 4 3 2 2 5 2 2 3 4 3 1 4 2 1 
1 4 4 5 3 4 3 5 1 4 2 5 2 1 4 4 5 4 5 2 
4 4 2 3 2 5 2 4 5 4 5 3 1 1 5 2 3 1 4 3 
*Pro_time*
44 54 26 32 31 59 48 82 89 81 9 6 94 81 67 9 60 83 98 22 
52 49 94 5 52 22 90 48 76 83 18 48 95 70 11 100 50 57 3 19 
19 55 31 56 26 61 89 66 29 11 12 66 29 61 3 80 45 4 31 38 
19 89 49 78 23 52 92 11 84 53 42 54 91 28 38 33 77 63 51 25 
94 47 59 77 50 41 63 15 1 19 42 17 28 33 30 27 41 49 7 8 
