jobs 100
stage 5
machines 4 2 1 5 4 
*Pro_req*
2 4 4 2 1 3 2 3 4 2 1 2 1 3 3 4 4 2 4 4 3 2 4 2 1 1 3 3 3 1 4 2 2 1 4 4 3 4 4 1 1 1 1 4 1 2 3 3 1 3 4 4 1 3 4 3 2 1 4 1 4 1 3 4 1 4 3 2 3 3 1 1 2 1 1 1 2 4 3 2 4 2 4 1 3 1 3 3 1 1 3 3 3 2 1 4 3 2 4 3 
2 2 1 1 1 1 2 2 2 1 2 2 2 1 2 1 1 2 2 1 1 2 2 2 2 2 1 2 1 2 1 2 2 1 1 2 1 2 2 2 2 2 1 2 1 1 2 1 2 1 1 2 2 1 1 1 2 1 2 2 1 2 1 2 1 1 1 2 1 1 2 2 1 2 1 2 2 1 2 1 2 1 1 2 2 2 2 2 1 2 1 1 2 1 2 2 2 2 1 1 
1 1 1 1 1 1 1 1 1 1 1 1 1 1 1 1 1 1 1 1 1 1 1 1 1 1 1 1 1 1 1 1 1 1 1 1 1 1 1 1 1 1 1 1 1 1 1 1 1 1 1 1 1 1 1 1 1 1 1 1 1 1 1 1 1 1 1 1 1 1 1 1 1 1 1 1 1 1 1 1 1 1 1 1 1 1 1 1 1 1 1 1 1 1 1 1 1 1 1 1 
3 2 4 3 4 4 2 3 4 3 3 5 2 5 5 3 4 1 5 4 1 3 3 1 3 3 5 2 4 1 3 5 4 1 1 1 3 4 3 1 3 2 1 3 3 3 1 5 2 1 3 3 4 1 1 3 1 2 5 1 3 1 4 3 4 1 2 2 4 4 5 3 4 1 1 1 5 1 3 3 1 2 4 1 4 3 3 4 3 3 1 3 4 5 3 5 5 5 5 2 
3 2 1 1 2 2 1 4 3 2 4 2 4 1 1 3 2 3 1 1 3 3 3 1 2 1 3 4 1 1 2 2 2 4 3 3 3 3 1 2 1 1 2 4 4 4 2 2 2 3 2 2 4 4 4 3 4 3 1 2 3 3 4 1 1 4 1 3 1 3 1 3 4 4 2 2 3 2 4 1 1 4 2 3 1 2 2 4 1 2 3 1 3 4 3 4 1 4 1 3 
*Pro_time*
69 57 1 40 21 52 10 18 68 16 17 5 57 48 30 42 42 55 19 91 27 90 55 72 45 12 68 85 6 60 57 33 15 10 23 89 31 66 96 21 2 81 55 87 99 42 80 62 98 23 56 22 98 18 93 68 47 22 45 70 48 15 10 43 15 48 6 51 34 71 33 5 45 47 59 49 23 58 55 61 78 59 57 74 59 3 31 50 69 96 15 100 10 2 11 66 24 31 52 36 
90 40 45 48 79 7 84 72 67 16 100 49 38 80 90 15 9 76 50 67 86 67 80 11 30 80 60 86 95 2 43 67 18 55 96 96 76 75 100 28 5 24 83 76 2 68 52 55 92 63 21 70 3 95 26 25 63 64 61 35 79 57 87 40 96 78 93 17 75 10 36 31 6 80 86 78 70 80 36 81 84 6 48 19 65 21 75 3 57 21 22 83 66 26 67 56 60 31 98 64 
54 67 93 47 42 86 7 5 33 28 67 16 90 23 92 25 10 17 11 44 3 75 60 13 50 18 31 93 77 82 51 62 87 25 87 45 89 92 53 62 85 31 36 5 5 5 96 50 39 77 82 20 70 96 38 30 56 8 13 40 74 78 92 57 27 39 48 11 55 62 53 30 95 78 84 35 93 100 92 14 6 63 4 45 74 71 62 7 10 25 99 28 4 79 43 16 33 91 64 38 
77 10 15 63 68 97 38 26 55 67 40 90 77 34 17 79 14 62 12 93 78 25 63 40 83 38 70 40 42 41 4 44 96 26 27 54 45 22 51 67 49 93 65 9 42 14 46 90 29 33 22 78 58 99 92 22 64 56 69 1 20 68 90 9 81 56 20 71 84 85 66 24 75 53 70 63 3 77 42 1 24 17 18 54 54 98 12 60 38 2 42 18 39 75 20 51 94 57 40 72 
27 89 1 9 40 32 95 50 28 83 26 87 59 18 55 59 66 90 40 19 16 55 31 37 17 57 49 47 68 91 87 19 22 24 58 93 85 55 69 52 51 23 36 94 11 68 46 38 70 94 72 92 32 74 91 96 48 26 95 4 16 11 92 11 29 26 68 60 75 99 91 80 73 10 29 26 18 35 32 65 79 57 13 52 11 56 48 85 84 80 59 94 23 85 64 59 20 21 41 43 
