jobs 100
stage 5
machines 3 5 4 1 1 
*Pro_req*
3 2 1 1 3 2 1 2 3 1 1 1 2 1 1 2 3 2 2 3 3 2 3 1 1 3 2 2 1 3 2 2 1 1 3 3 2 2 3 3 3 2 2 2 1 2 1 1 3 1 1 1 1 3 2 1 3 3 2 1 3 3 2 1 2 3 3 3 1 3 3 3 3 1 1 3 3 1 3 1 2 3 1 3 2 1 3 1 1 2 2 3 3 3 1 1 3 2 3 1 
3 2 2 5 2 5 3 1 2 4 2 1 2 3 4 1 5 2 2 4 4 1 2 1 1 5 1 5 5 3 4 3 3 4 3 5 4 4 3 4 1 1 4 3 3 5 5 5 5 4 2 3 4 4 3 4 2 2 1 2 3 2 5 4 2 2 5 4 5 1 5 3 4 1 5 2 2 4 1 1 3 2 4 3 1 5 3 1 2 1 3 4 2 2 5 3 1 4 1 3 
3 3 3 1 1 2 2 2 3 4 1 2 1 4 3 3 3 2 4 1 1 1 1 3 3 4 2 2 2 4 1 4 2 2 3 4 3 4 2 1 3 1 2 3 2 2 2 2 4 1 2 2 2 1 4 3 4 4 4 1 3 1 1 3 4 4 2 3 1 3 2 4 1 1 3 1 3 4 2 2 1 4 4 4 2 3 4 1 2 1 4 4 4 1 1 4 3 1 1 1 
1 1 1 1 1 1 1 1 1 1 1 1 1 1 1 1 1 1 1 1 1 1 1 1 1 1 1 1 1 1 1 1 1 1 1 1 1 1 1 1 1 1 1 1 1 1 1 1 1 1 1 1 1 1 1 1 1 1 1 1 1 1 1 1 1 1 1 1 1 1 1 1 1 1 1 1 1 1 1 1 1 1 1 1 1 1 1 1 1 1 1 1 1 1 1 1 1 1 1 1 
1 1 1 1 1 1 1 1 1 1 1 1 1 1 1 1 1 1 1 1 1 1 1 1 1 1 1 1 1 1 1 1 1 1 1 1 1 1 1 1 1 1 1 1 1 1 1 1 1 1 1 1 1 1 1 1 1 1 1 1 1 1 1 1 1 1 1 1 1 1 1 1 1 1 1 1 1 1 1 1 1 1 1 1 1 1 1 1 1 1 1 1 1 1 1 1 1 1 1 1 
*Pro_time*
14 72 98 69 12 100 81 65 50 53 82 43 42 28 50 4 42 65 51 51 80 53 62 88 78 52 63 67 57 37 26 3 49 36 74 72 30 35 39 73 21 66 52 20 31 76 80 80 72 80 29 60 64 82 36 29 8 64 71 99 35 81 8 21 5 91 66 28 44 94 83 40 74 44 15 30 26 7 63 59 74 59 44 79 44 41 47 55 58 39 56 32 78 84 61 32 70 83 18 43 
74 53 84 12 4 57 14 86 87 92 61 53 18 81 8 65 74 31 78 49 64 32 42 68 33 47 80 19 92 59 15 52 31 74 68 56 67 85 56 2 76 74 30 94 67 98 46 54 47 75 29 66 24 31 69 22 100 8 53 99 2 70 32 94 30 24 48 58 27 6 7 14 73 29 22 52 55 72 87 74 49 41 10 77 65 32 49 18 10 31 32 55 19 89 91 11 6 69 98 26 
94 67 55 72 84 75 88 36 36 60 66 39 90 13 87 60 77 21 80 11 74 7 25 63 75 46 61 13 6 2 5 33 83 69 68 83 25 97 15 81 52 93 61 7 43 77 77 6 90 23 37 18 71 94 2 28 49 36 57 47 14 77 80 88 48 68 64 12 70 27 80 1 55 24 66 12 68 2 61 75 68 57 49 57 91 77 42 48 1 69 12 71 63 33 54 33 39 30 39 24 
4 36 85 85 57 68 87 31 75 66 49 54 9 17 94 33 25 54 48 92 78 86 100 72 81 28 86 96 3 10 96 60 37 21 87 16 98 36 70 60 47 56 27 17 5 35 46 34 58 59 61 32 69 21 42 3 57 26 33 38 96 24 74 44 57 28 89 9 93 80 3 47 31 23 21 20 52 90 23 80 100 73 81 71 92 15 40 67 71 84 76 65 41 87 56 19 60 65 79 23 
63 55 52 98 98 66 19 46 98 72 67 22 65 39 36 65 10 54 35 88 63 100 98 25 31 84 66 26 62 49 3 22 2 27 21 18 30 49 97 19 21 8 42 43 95 36 71 60 28 93 52 22 65 24 73 7 99 66 80 46 26 88 73 83 6 5 21 35 31 97 22 16 73 20 99 70 5 90 49 44 7 80 51 14 86 69 19 94 26 81 60 26 76 60 16 73 44 48 11 23 
