jobs 100
stage 5
machines 3 4 2 2 5 
*Pro_req*
3 3 2 1 3 3 2 2 2 1 3 2 3 3 2 2 2 2 3 3 2 3 2 2 2 1 2 3 1 2 3 3 3 1 2 2 2 2 2 3 2 1 2 3 1 3 3 3 2 3 1 1 2 3 1 1 2 3 3 1 1 1 2 3 1 3 1 1 3 1 3 1 3 3 1 3 2 2 2 3 3 3 1 3 1 2 2 2 1 2 3 3 2 2 3 2 2 2 3 2 
1 1 4 2 1 3 3 2 3 4 1 2 1 2 4 1 1 4 4 3 4 1 3 3 1 2 1 1 1 3 1 2 1 1 1 2 3 1 4 2 2 4 4 2 1 4 3 2 2 1 4 3 2 1 2 2 3 3 2 2 4 2 1 1 2 2 2 3 4 2 4 4 4 1 1 1 2 4 1 1 4 3 4 2 4 3 4 3 3 4 2 1 4 4 4 1 3 2 2 3 
2 2 1 1 2 2 2 1 1 1 2 1 2 2 1 1 2 2 1 2 1 2 1 2 1 1 2 1 1 2 1 2 2 2 1 2 2 2 1 2 1 2 2 2 1 1 2 1 1 1 1 1 1 2 2 1 1 1 1 1 2 1 1 1 2 1 2 2 1 2 1 1 1 1 2 2 2 1 1 1 1 2 2 2 2 2 1 2 2 1 2 2 1 2 2 1 2 2 1 1 
1 2 1 2 1 2 2 1 1 2 2 1 2 2 1 2 2 1 1 1 1 2 2 1 1 1 1 1 1 2 2 2 2 2 2 1 2 2 1 1 2 1 2 1 1 2 1 2 1 1 2 2 1 1 1 1 2 1 1 1 1 2 2 2 2 2 1 1 1 2 2 2 1 1 2 1 2 1 1 2 2 2 2 1 1 2 1 2 2 2 2 2 1 1 2 2 2 2 2 1 
2 1 3 1 1 4 2 1 4 1 1 5 3 3 3 5 3 3 3 2 4 5 4 4 5 1 4 5 5 5 5 5 4 1 5 2 5 5 2 2 3 5 1 5 5 3 1 1 1 2 5 1 2 2 3 4 4 1 2 3 5 1 1 5 2 1 5 2 4 3 3 3 4 4 3 4 4 4 4 3 3 3 3 4 2 3 5 2 3 5 3 2 5 2 2 5 5 5 1 5 
*Pro_time*
62 7 18 56 37 86 88 21 72 79 11 37 55 51 83 19 40 52 62 86 29 55 99 62 95 8 14 45 29 40 89 57 41 72 38 21 7 36 99 78 41 67 29 84 23 65 99 78 38 16 6 97 91 1 32 70 79 45 75 64 100 55 94 63 64 25 4 36 68 70 8 6 89 18 83 15 33 45 85 22 21 12 34 19 12 79 6 6 79 84 7 74 53 56 58 43 30 40 9 35 
29 69 12 85 34 97 2 75 81 94 93 83 2 95 46 92 42 77 82 63 24 2 64 58 97 30 8 75 72 23 90 63 86 94 23 87 43 91 58 28 17 46 16 77 49 52 54 77 9 75 97 60 95 79 91 23 4 26 26 58 58 70 5 71 62 12 13 92 58 16 31 5 6 22 92 95 72 83 51 23 49 38 19 50 77 60 25 81 90 56 99 84 78 56 88 41 59 30 7 13 
91 76 51 96 47 50 88 41 53 32 63 25 60 28 64 56 3 96 50 88 21 31 100 83 96 15 42 24 15 23 85 62 39 40 24 15 14 47 46 77 86 32 4 27 29 1 28 56 29 70 2 2 6 80 6 7 68 36 48 55 64 51 16 58 7 20 79 58 35 7 65 85 53 69 79 64 22 23 51 47 62 10 56 34 31 59 59 33 61 82 63 96 42 8 26 62 66 3 78 92 
58 29 14 40 53 53 53 37 94 78 51 44 7 40 67 67 96 38 25 4 78 99 44 45 81 25 6 100 42 43 29 6 44 89 86 29 78 8 50 21 90 81 6 90 38 45 66 76 53 100 26 11 35 100 90 96 39 18 51 60 9 2 72 39 34 87 1 90 27 80 25 26 46 58 72 27 86 20 22 31 19 57 91 52 19 18 38 55 47 51 96 3 93 38 85 77 71 71 49 13 
73 35 37 92 82 79 58 61 4 18 93 95 29 91 56 67 13 58 63 86 27 22 26 75 51 65 77 64 71 23 76 17 54 33 32 37 88 36 53 90 50 95 98 40 37 74 94 41 92 56 74 62 78 59 28 64 60 40 58 57 17 28 66 15 92 16 34 9 82 67 61 66 67 42 90 84 22 45 92 6 39 43 10 64 92 44 38 78 39 67 33 69 18 34 88 2 75 33 42 8 
