jobs 100
stage 5
machines 1 5 3 2 1 
*Pro_req*
1 1 1 1 1 1 1 1 1 1 1 1 1 1 1 1 1 1 1 1 1 1 1 1 1 1 1 1 1 1 1 1 1 1 1 1 1 1 1 1 1 1 1 1 1 1 1 1 1 1 1 1 1 1 1 1 1 1 1 1 1 1 1 1 1 1 1 1 1 1 1 1 1 1 1 1 1 1 1 1 1 1 1 1 1 1 1 1 1 1 1 1 1 1 1 1 1 1 1 1 
1 2 5 1 3 2 3 5 5 3 4 2 3 1 5 2 3 4 5 3 3 3 4 4 4 3 3 5 2 1 4 4 3 2 5 5 1 5 1 2 5 1 4 5 3 4 2 5 2 1 4 2 4 4 1 2 4 4 1 1 1 2 5 3 5 3 2 2 2 5 4 5 1 5 5 5 4 3 2 4 1 5 4 4 3 1 1 4 4 2 4 1 1 5 5 3 1 4 4 4 
3 2 3 1 3 2 1 2 2 1 1 1 3 1 1 3 3 1 1 2 1 3 2 2 1 3 2 2 3 1 1 2 1 1 3 3 2 1 2 3 2 3 3 2 2 1 3 2 3 2 3 1 3 3 2 1 1 2 2 1 1 1 1 3 2 1 3 3 3 2 3 1 1 3 1 2 3 1 1 1 3 2 1 1 1 1 2 3 1 1 2 1 3 1 3 1 1 1 1 1 
1 1 2 1 2 1 2 1 2 2 1 2 2 1 2 2 2 1 2 1 1 1 2 1 1 1 2 2 1 2 2 2 2 2 1 2 2 1 1 1 2 2 1 2 2 1 2 2 2 1 2 2 1 1 1 1 2 1 2 2 1 2 2 2 2 2 2 2 2 1 1 1 1 1 2 1 1 1 1 2 1 2 2 2 1 2 1 2 1 2 2 1 2 1 1 1 1 2 2 2 
1 1 1 1 1 1 1 1 1 1 1 1 1 1 1 1 1 1 1 1 1 1 1 1 1 1 1 1 1 1 1 1 1 1 1 1 1 1 1 1 1 1 1 1 1 1 1 1 1 1 1 1 1 1 1 1 1 1 1 1 1 1 1 1 1 1 1 1 1 1 1 1 1 1 1 1 1 1 1 1 1 1 1 1 1 1 1 1 1 1 1 1 1 1 1 1 1 1 1 1 
*Pro_time*
94 4 1 88 60 34 81 88 75 82 80 2 1 90 11 36 97 61 6 75 74 89 59 15 76 19 23 55 85 94 76 90 57 17 59 42 23 4 50 88 92 90 93 97 43 70 36 10 97 89 31 93 4 18 56 76 67 3 29 36 48 87 25 50 70 31 16 47 68 69 76 99 21 51 87 36 87 19 94 45 21 41 63 41 89 17 38 61 25 26 65 72 90 39 48 38 33 96 32 31 
32 91 68 48 81 59 45 70 19 52 47 54 15 84 53 27 33 52 7 54 23 43 66 13 78 56 32 90 49 20 65 36 23 85 45 34 85 40 52 18 47 40 88 54 69 72 75 14 28 4 34 40 69 21 33 27 99 37 86 7 33 23 6 25 65 92 24 63 18 16 60 44 3 87 5 21 33 46 71 95 85 90 10 59 16 76 24 87 9 58 14 2 51 85 5 47 86 86 3 14 
11 52 9 98 10 55 84 90 95 38 48 8 43 97 92 73 58 41 87 87 59 18 70 27 59 52 26 82 79 15 12 88 39 64 38 91 52 76 21 81 1 84 97 94 63 9 34 29 59 1 52 85 78 32 19 51 79 93 14 94 66 10 64 4 4 3 33 64 43 59 42 78 25 59 45 30 88 38 32 62 62 20 33 22 55 47 12 52 30 98 80 86 50 80 81 85 64 35 81 100 
75 24 34 71 45 55 93 33 84 63 98 95 50 33 28 21 46 4 11 100 6 56 36 29 62 74 50 76 19 26 69 22 36 40 18 23 85 76 91 94 18 64 69 56 53 35 8 34 33 3 1 45 45 34 86 42 33 36 4 20 67 23 47 19 80 22 96 3 82 32 74 97 74 1 9 8 86 27 53 5 91 63 20 10 46 38 38 72 37 39 68 35 54 76 48 56 98 61 89 12 
71 13 73 88 16 91 55 40 38 87 31 17 92 86 52 12 67 29 97 58 47 93 78 61 26 48 66 22 36 13 45 12 80 36 85 23 95 22 38 87 56 82 39 88 29 89 35 37 40 5 28 47 68 47 11 72 17 48 54 71 61 63 81 87 69 87 55 47 73 41 75 53 86 59 71 85 99 59 52 45 29 18 98 39 53 64 75 98 91 8 1 41 37 88 14 61 41 4 33 97 
