jobs 50
stage 5
machines 5 5 5 5 5 
*Pro_req*
3 2 4 4 2 4 5 1 3 1 1 5 5 3 1 4 4 1 3 5 3 1 1 3 4 1 1 3 3 4 2 1 4 5 5 5 1 3 4 5 5 5 2 4 2 4 5 5 2 1 
2 4 5 1 1 1 5 2 1 3 4 3 1 5 4 5 5 3 3 4 2 2 3 3 2 5 1 3 5 3 5 1 1 2 1 4 1 1 1 3 5 1 2 5 1 4 5 3 1 2 
1 1 3 4 2 5 4 1 2 1 1 1 5 2 1 3 4 1 3 3 2 2 5 3 1 5 2 2 2 2 3 2 4 5 5 1 5 2 1 2 1 2 1 5 4 1 3 4 5 5 
3 4 4 3 2 3 1 3 2 5 1 2 5 4 3 2 5 3 4 1 3 5 2 5 2 2 2 5 2 5 1 4 3 1 5 5 4 5 4 2 2 5 5 4 5 2 1 3 4 2 
4 4 4 1 1 1 1 4 4 1 1 1 1 5 1 2 2 3 1 3 3 1 4 5 1 3 4 3 1 4 2 3 1 5 5 2 5 5 3 2 1 2 2 2 3 5 2 4 2 5 
*Pro_time*
89 45 92 63 100 45 11 73 36 96 35 4 28 83 63 43 54 19 73 98 81 24 46 65 63 36 45 45 17 56 38 37 97 12 79 26 41 63 25 45 49 83 3 53 30 8 29 42 27 64 
96 41 65 62 43 57 34 13 31 56 92 12 53 63 48 73 45 69 12 2 73 53 83 82 4 88 42 68 60 50 64 79 99 30 36 77 23 51 96 52 41 21 28 82 51 100 9 65 47 53 
21 62 19 12 49 29 18 14 67 56 2 9 29 42 92 94 51 12 15 66 64 9 72 88 53 69 14 5 49 44 79 47 20 44 16 31 49 24 99 85 98 39 53 48 30 72 14 62 9 22 
85 72 69 9 39 26 27 93 61 81 68 66 3 68 22 27 60 12 68 30 94 24 10 51 77 69 77 86 59 27 14 74 36 19 24 14 52 4 28 43 92 40 67 95 23 12 46 42 29 47 
53 44 16 59 93 21 50 91 100 58 96 29 55 83 80 91 7 33 23 82 37 73 95 91 39 40 89 40 17 96 40 51 57 100 66 88 46 20 65 10 50 26 81 71 93 90 82 24 58 70 
