jobs 50
stage 5
machines 5 5 5 5 5 
*Pro_req*
3 4 1 2 3 5 4 5 1 1 4 1 2 4 5 2 3 2 3 1 1 3 3 3 1 1 1 2 4 5 5 2 2 1 2 3 2 5 3 1 3 4 2 3 4 2 3 3 1 5 
1 2 3 1 5 3 5 5 5 4 2 4 5 4 1 5 2 3 4 3 1 4 5 3 3 3 2 1 4 2 4 2 3 3 5 5 4 4 5 1 5 5 4 1 2 3 3 1 5 1 
1 1 3 2 3 4 1 5 4 2 3 1 2 5 3 2 3 2 2 2 3 3 2 5 1 5 4 2 3 5 1 1 1 1 1 4 3 1 1 3 1 1 1 3 5 3 3 1 4 3 
3 2 2 4 1 4 4 5 1 1 1 2 5 3 3 3 5 2 2 1 2 2 4 5 4 5 1 1 2 1 4 4 5 2 2 4 1 4 3 3 3 3 4 2 2 5 2 3 5 3 
1 3 3 4 4 5 1 5 4 3 2 4 1 1 2 1 3 5 5 5 1 4 1 5 3 5 2 3 2 4 4 2 5 4 1 5 4 3 2 5 2 2 4 1 4 3 2 5 2 2 
*Pro_time*
43 8 4 67 63 62 35 11 46 87 25 21 73 80 47 6 59 89 54 15 85 64 89 86 85 46 83 71 55 49 41 22 16 95 84 44 32 48 83 34 12 6 24 10 36 42 78 97 94 13 
83 92 4 16 76 71 81 41 61 71 50 7 5 70 72 49 24 35 49 32 59 50 76 94 15 40 53 93 63 45 37 72 29 5 85 7 80 63 43 93 15 40 51 55 52 17 38 13 89 47 
62 54 88 67 79 14 83 14 80 27 7 45 95 38 64 27 36 65 6 95 68 21 73 98 78 42 12 19 59 58 91 7 97 77 3 15 31 43 1 16 77 45 67 62 92 26 6 54 37 98 
93 28 57 38 51 52 2 66 97 52 66 11 33 7 9 53 51 3 51 35 8 31 96 97 58 63 61 72 75 2 59 79 91 22 52 52 62 95 54 71 4 1 95 14 61 36 92 70 87 98 
71 11 14 56 98 53 71 84 3 87 26 64 9 97 44 62 54 26 84 95 46 49 11 76 97 17 72 33 31 95 96 83 29 13 6 20 73 98 81 25 82 53 55 28 91 14 51 34 72 85 
