jobs 50
stage 5
machines 5 5 5 5 5 
*Pro_req*
4 5 3 5 1 4 3 3 3 3 1 1 3 2 2 2 5 4 1 3 3 5 1 1 3 5 2 2 4 2 1 4 2 1 2 1 4 3 1 4 1 1 4 2 3 3 2 2 2 2 
1 5 5 3 5 1 2 4 1 1 4 3 1 4 5 3 5 2 2 4 3 1 1 1 2 5 1 3 3 2 3 5 5 4 4 1 3 1 3 5 3 5 3 2 3 3 4 1 4 1 
4 1 5 1 5 5 5 1 4 2 5 1 5 1 4 1 3 4 4 4 5 5 5 1 2 5 4 5 1 4 1 4 1 3 5 1 5 2 4 3 2 3 1 5 3 2 1 5 4 2 
4 5 5 4 3 1 4 2 3 4 3 5 4 5 2 3 5 4 5 1 1 5 1 3 3 1 4 1 4 4 4 3 5 5 5 5 4 3 3 4 1 5 3 3 3 1 1 5 5 1 
4 3 4 4 5 2 3 3 3 2 4 2 2 1 2 4 1 1 4 1 3 4 3 2 2 4 2 1 5 1 5 2 5 5 2 2 5 1 3 2 4 4 1 5 3 2 4 4 4 2 
*Pro_time*
42 45 39 82 86 93 87 40 34 15 54 17 79 100 8 58 76 3 20 59 97 77 62 57 45 61 17 22 89 86 14 39 84 44 68 13 23 29 43 94 96 66 44 83 98 38 41 34 44 57 
31 30 8 74 87 14 93 90 4 9 6 81 49 86 51 21 8 57 100 85 24 49 82 68 91 77 94 82 93 62 39 95 86 9 13 15 67 91 98 14 49 32 81 34 31 78 31 54 42 11 
67 37 24 78 99 62 99 44 90 34 81 22 81 81 52 20 37 29 45 8 26 80 87 50 46 13 46 66 9 64 13 13 23 23 39 86 41 37 95 50 75 79 38 93 89 60 28 81 18 90 
45 71 92 57 67 100 41 20 11 8 97 73 50 13 91 93 62 96 92 29 88 52 48 9 46 48 49 93 73 2 80 74 69 21 42 33 33 6 24 33 16 66 77 39 16 88 26 30 16 92 
46 32 87 78 64 20 66 89 69 46 73 67 6 90 100 48 94 23 3 83 9 65 12 15 77 52 27 68 57 94 36 64 31 87 51 63 4 99 23 19 15 89 60 14 3 49 28 35 98 32 
