jobs 10
stage 8
machines 4 2 3 4 1 2 3 1 
*Pro_req*
4 4 2 2 1 4 3 1 3 2 
1 2 2 1 1 1 2 1 2 1 
3 2 1 1 1 2 3 2 1 1 
1 1 3 1 1 3 2 1 4 4 
1 1 1 1 1 1 1 1 1 1 
1 1 1 2 1 2 1 1 1 1 
1 2 2 3 2 2 3 1 1 2 
1 1 1 1 1 1 1 1 1 1 
*Pro_time*
31 73 27 39 19 3 83 50 93 93 
8 98 51 81 60 11 98 99 66 26 
42 37 55 66 71 49 72 62 72 46 
54 20 21 66 45 92 86 34 7 15 
77 62 15 82 30 38 45 88 48 4 
53 34 14 2 23 47 59 28 52 39 
45 63 12 1 72 45 74 13 9 43 
96 85 95 24 18 14 27 51 29 18 
