jobs 10
stage 8
machines 5 3 3 1 4 2 1 3 
*Pro_req*
4 1 2 4 3 5 3 5 5 4 
2 1 2 1 3 2 1 3 3 3 
3 1 2 2 1 2 3 3 2 3 
1 1 1 1 1 1 1 1 1 1 
4 2 2 2 2 3 1 3 2 4 
1 1 2 2 2 2 1 1 1 2 
1 1 1 1 1 1 1 1 1 1 
2 1 2 1 3 2 3 3 3 1 
*Pro_time*
6 13 97 7 15 71 77 47 61 42 
14 22 67 59 32 33 96 54 95 19 
55 72 73 2 42 49 50 76 7 72 
43 84 28 25 10 78 45 17 43 66 
42 2 70 7 93 56 63 67 85 51 
78 95 10 31 45 65 54 19 21 37 
9 55 32 12 48 81 98 90 81 86 
67 7 84 61 36 98 27 23 80 23 
