jobs 10
stage 8
machines 3 5 2 2 3 1 5 4 
*Pro_req*
3 1 1 1 2 2 2 3 1 3 
4 4 5 3 2 1 4 1 2 1 
2 2 2 2 1 1 1 2 2 1 
1 1 1 1 2 1 1 1 2 2 
1 2 1 3 3 3 1 2 2 3 
1 1 1 1 1 1 1 1 1 1 
2 5 3 5 5 3 3 5 3 3 
3 3 2 3 4 3 2 1 3 4 
*Pro_time*
27 26 86 14 11 16 18 87 21 69 
52 41 54 97 65 52 62 35 11 14 
55 45 20 24 2 70 2 51 99 17 
90 71 19 1 48 69 92 90 18 74 
68 54 17 20 61 2 35 24 50 14 
17 92 82 49 46 34 7 39 52 59 
23 42 100 67 65 86 36 22 49 56 
37 93 50 32 28 8 45 57 30 79 
