jobs 10
stage 8
machines 1 2 4 5 1 1 4 5 
*Pro_req*
1 1 1 1 1 1 1 1 1 1 
2 1 1 1 1 2 1 2 2 2 
3 1 3 3 1 1 1 4 3 4 
2 3 5 4 1 4 5 1 2 1 
1 1 1 1 1 1 1 1 1 1 
1 1 1 1 1 1 1 1 1 1 
4 2 4 2 3 4 4 4 3 1 
2 4 2 5 2 4 4 4 5 4 
*Pro_time*
46 41 21 53 37 15 19 48 42 47 
53 10 59 30 44 11 79 28 36 75 
85 94 14 75 61 58 49 87 16 25 
60 68 91 15 80 32 11 63 25 6 
63 82 95 61 39 54 92 60 10 58 
43 86 82 83 94 98 67 69 100 93 
18 28 34 7 42 66 7 21 49 80 
21 17 70 95 52 41 28 46 62 93 
