jobs 10
stage 8
machines 1 5 4 2 5 1 5 3 
*Pro_req*
1 1 1 1 1 1 1 1 1 1 
2 5 2 3 5 4 3 5 3 4 
4 3 2 4 3 3 2 2 4 1 
1 1 1 1 2 2 2 2 2 2 
4 3 4 3 1 4 5 5 5 3 
1 1 1 1 1 1 1 1 1 1 
2 4 1 4 3 3 4 2 4 2 
3 2 1 3 2 1 1 3 2 3 
*Pro_time*
90 48 100 81 92 45 43 67 68 57 
65 67 71 2 6 62 94 95 86 91 
4 80 75 81 99 72 57 54 33 55 
41 84 81 70 63 40 18 52 7 17 
26 52 9 100 42 42 56 17 41 47 
27 18 17 27 25 14 39 3 9 80 
76 71 21 48 100 6 85 67 42 25 
45 45 60 14 68 37 97 37 63 31 
