jobs 10
stage 8
machines 5 5 1 5 3 3 3 4 
*Pro_req*
1 3 3 5 2 3 4 1 2 5 
3 1 1 4 2 2 5 1 3 2 
1 1 1 1 1 1 1 1 1 1 
2 1 1 1 5 3 3 2 1 3 
3 1 3 1 3 3 1 3 2 1 
3 3 3 1 3 2 1 3 1 1 
2 2 1 1 1 2 2 3 3 3 
4 1 1 2 4 3 2 3 1 4 
*Pro_time*
42 41 14 57 22 62 81 88 64 19 
59 92 100 52 77 48 23 46 85 53 
86 30 36 27 9 64 56 14 32 77 
81 86 26 66 71 41 56 26 97 76 
91 98 21 18 19 92 16 34 54 7 
30 44 18 44 80 37 58 46 75 66 
55 47 7 20 88 35 55 30 77 5 
84 76 40 44 28 41 57 97 65 71 
