jobs 10
stage 8
machines 4 2 5 1 2 3 3 3 
*Pro_req*
1 4 2 1 3 3 4 4 1 4 
1 2 2 1 2 2 2 1 2 1 
4 4 1 4 1 5 1 2 5 2 
1 1 1 1 1 1 1 1 1 1 
1 1 2 1 1 2 1 2 2 2 
2 2 3 1 1 2 2 2 2 2 
1 2 3 2 2 3 1 3 2 3 
2 1 2 1 2 2 1 1 3 1 
*Pro_time*
16 80 29 37 1 33 62 1 81 30 
72 8 89 55 24 74 84 90 69 98 
53 76 12 9 28 97 29 52 91 4 
70 34 10 23 70 28 24 76 42 71 
95 66 20 49 99 1 20 78 67 68 
17 49 14 59 2 65 39 35 69 43 
77 94 19 83 30 94 92 53 62 88 
85 35 92 86 16 60 16 43 82 13 
