jobs 10
stage 8
machines 3 1 1 3 5 5 1 4 
*Pro_req*
1 2 3 2 2 3 2 3 2 1 
1 1 1 1 1 1 1 1 1 1 
1 1 1 1 1 1 1 1 1 1 
1 1 3 3 1 2 1 1 3 3 
2 2 3 2 3 2 3 4 1 1 
5 4 5 2 2 5 2 4 3 1 
1 1 1 1 1 1 1 1 1 1 
1 1 1 2 4 3 3 4 4 4 
*Pro_time*
58 49 69 88 55 65 70 74 40 12 
18 75 30 39 1 36 5 63 82 90 
14 32 45 9 56 69 84 95 46 25 
30 25 86 13 56 30 92 67 58 30 
60 49 24 1 38 35 44 6 75 5 
80 20 65 40 9 34 18 54 99 92 
10 75 73 40 49 25 79 99 27 68 
4 67 67 40 81 94 40 92 82 37 
