jobs 10
stage 8
machines 3 2 4 5 5 5 2 4 
*Pro_req*
3 3 2 2 1 1 2 2 3 3 
2 1 1 2 2 1 2 2 1 1 
4 4 4 1 4 4 4 1 2 4 
4 3 4 5 4 5 5 1 4 2 
5 5 4 1 1 3 4 1 4 3 
2 1 1 2 5 5 4 5 1 4 
1 2 2 2 2 2 2 2 1 1 
4 4 3 4 4 2 1 2 1 4 
*Pro_time*
40 11 72 71 54 24 22 71 48 4 
32 94 25 12 46 9 36 2 92 94 
32 45 25 57 43 12 75 84 41 79 
33 19 41 26 56 44 55 12 1 94 
22 46 44 16 40 21 11 24 50 92 
29 88 57 98 79 3 36 75 74 27 
50 27 94 98 21 96 31 67 5 84 
53 21 55 47 85 3 86 78 1 3 
