jobs 10
stage 8
machines 1 2 2 1 2 5 5 5 
*Pro_req*
1 1 1 1 1 1 1 1 1 1 
2 1 2 1 1 1 1 1 1 2 
1 2 1 2 2 1 2 2 1 2 
1 1 1 1 1 1 1 1 1 1 
1 1 2 2 2 1 1 2 2 2 
5 5 4 1 4 3 1 1 3 1 
3 4 3 4 3 1 4 3 2 3 
2 2 1 2 1 2 3 4 2 5 
*Pro_time*
64 76 6 23 63 58 18 13 8 62 
22 77 42 21 75 11 17 9 58 99 
6 6 7 57 100 74 67 30 97 3 
75 90 1 71 30 86 21 28 57 32 
35 24 3 13 38 17 93 74 14 51 
8 92 83 85 50 27 24 56 38 14 
6 4 76 89 71 58 79 62 56 59 
42 27 74 13 35 89 14 22 49 68 
