jobs 100
stage 8
machines 4 5 2 4 5 2 2 5 
*Pro_req*
4 3 2 4 1 4 3 3 2 3 2 2 1 4 2 4 3 1 4 1 2 2 4 3 4 3 1 2 3 3 2 1 2 3 4 3 4 2 1 1 4 1 1 3 1 2 2 2 1 2 4 2 4 3 1 2 2 1 4 4 2 4 2 1 1 4 2 3 3 3 1 4 4 2 2 1 1 3 3 1 1 3 3 4 3 1 2 4 3 3 1 4 4 4 3 2 4 2 4 4 
1 3 1 4 3 2 5 3 2 2 5 4 3 4 5 5 5 2 5 4 4 1 1 1 3 5 1 5 3 2 5 2 5 4 4 5 4 1 5 5 4 5 4 1 2 3 2 1 3 5 5 5 3 5 1 1 2 3 4 1 4 4 1 1 2 2 3 1 4 5 3 4 2 2 2 5 1 2 4 2 1 5 2 4 5 5 4 1 4 4 1 2 3 5 2 5 3 5 4 4 
1 2 1 2 1 2 1 2 2 2 2 1 2 2 1 2 1 2 2 1 2 2 1 1 2 1 1 1 1 1 1 2 1 1 1 2 1 2 2 1 2 1 2 1 1 2 1 2 1 1 1 1 2 1 1 2 1 2 1 1 2 2 1 2 2 2 1 1 2 2 1 2 1 1 1 1 2 1 2 1 1 1 2 1 1 2 1 1 2 1 1 2 2 1 1 1 2 1 2 2 
4 1 1 2 1 2 4 3 4 2 1 2 3 3 2 3 4 2 1 3 1 1 4 2 3 4 1 2 1 4 4 1 1 4 2 4 2 1 2 4 3 3 2 1 2 3 4 3 4 2 1 3 2 3 4 4 3 4 3 2 3 3 1 2 2 4 3 3 3 4 2 3 2 4 1 1 3 1 4 2 1 2 1 2 2 3 4 3 4 2 1 3 4 4 1 1 4 2 4 3 
3 3 1 1 5 3 5 3 4 1 2 4 5 2 2 5 3 2 3 1 4 4 5 2 4 2 1 4 1 3 1 4 2 4 2 2 4 1 3 2 4 2 3 3 5 2 5 4 4 2 4 3 1 1 4 2 5 5 1 1 1 2 4 1 4 5 3 2 2 1 4 3 1 5 2 2 1 3 3 4 1 1 3 1 3 4 4 5 3 4 5 1 5 1 2 5 3 2 1 1 
1 2 2 1 2 2 1 2 2 1 1 2 2 1 2 1 1 2 1 2 2 2 1 1 2 1 2 2 1 2 1 2 2 2 1 2 1 2 2 1 1 2 2 1 1 1 1 2 2 1 1 2 2 1 2 1 1 2 2 2 2 1 2 1 2 2 2 2 1 1 1 2 1 1 2 1 1 1 1 1 1 2 1 1 2 1 1 2 2 1 2 1 2 2 1 1 2 1 2 1 
2 1 2 1 1 1 2 2 2 2 2 1 2 1 1 2 1 1 2 2 2 1 2 2 1 2 1 1 1 2 2 2 1 2 1 1 2 1 2 1 1 2 1 1 1 2 2 2 1 2 2 2 2 1 2 2 1 1 1 1 1 2 2 1 1 1 1 1 1 1 2 1 1 1 2 1 2 2 2 1 1 1 1 1 1 1 1 1 2 2 1 2 1 2 1 2 1 1 2 1 
4 4 5 1 3 3 5 3 3 1 2 1 3 3 1 2 1 3 1 1 5 3 2 4 3 2 2 3 2 4 4 5 3 5 4 4 4 3 1 4 4 4 2 3 1 3 3 5 1 3 4 5 3 3 4 1 4 2 5 4 3 3 2 3 4 2 2 5 4 3 4 4 2 3 1 4 2 5 4 5 4 4 2 1 3 5 4 5 5 5 3 1 3 5 4 5 1 1 5 5 
*Pro_time*
53 68 71 56 41 51 4 69 66 50 1 13 35 81 100 7 75 98 27 40 50 11 60 46 18 22 96 66 38 59 12 68 4 87 50 46 84 91 97 55 16 39 7 14 12 9 59 94 33 43 64 61 9 20 46 96 12 29 64 44 3 52 33 31 99 22 76 50 63 48 97 59 49 60 30 87 74 40 57 28 2 11 92 50 87 99 8 79 45 54 55 38 28 45 47 76 67 52 50 2 
15 26 29 29 27 71 16 52 59 85 95 7 40 54 1 19 30 79 46 43 74 41 48 10 69 100 27 59 89 43 41 72 75 22 76 51 12 2 27 41 15 42 51 65 3 92 73 36 74 62 100 9 32 51 7 44 45 56 47 26 22 29 8 62 24 100 69 25 35 85 98 45 95 12 71 98 28 83 11 77 66 74 5 49 34 5 42 73 36 85 10 60 67 15 39 12 82 88 36 73 
30 22 41 68 77 8 75 64 31 75 69 84 86 65 91 95 26 97 100 33 67 1 65 83 18 94 40 28 34 86 92 62 17 44 78 71 38 75 81 11 22 6 18 88 43 83 99 1 58 85 71 98 57 44 26 40 36 13 62 73 57 55 67 54 13 95 71 59 21 14 97 82 40 87 72 89 26 98 78 76 34 99 40 78 39 1 37 26 7 39 30 54 66 97 14 11 80 75 23 39 
64 97 20 76 51 10 74 60 77 94 62 94 19 38 38 98 72 24 30 35 94 92 27 82 81 57 84 81 20 42 77 7 53 45 58 81 2 32 2 37 18 12 35 44 28 85 7 46 17 68 79 19 47 98 66 40 80 58 72 37 71 23 18 57 69 3 58 65 63 65 22 73 58 45 55 6 78 52 87 34 58 41 32 55 47 56 100 44 90 72 60 86 19 53 61 92 89 79 81 16 
81 30 85 28 25 15 84 20 2 95 48 80 65 86 13 9 72 38 69 45 17 53 83 44 13 83 91 66 15 79 89 88 40 46 76 77 28 67 50 29 2 44 72 62 56 49 15 56 71 87 7 49 82 79 64 64 72 39 22 100 74 47 21 96 32 34 86 54 55 10 48 39 65 15 24 79 34 8 1 19 42 55 13 34 53 47 52 1 82 29 43 50 46 75 42 81 82 56 54 77 
80 91 59 78 67 9 21 21 29 78 61 52 50 19 23 39 42 62 24 12 52 53 44 99 54 36 69 63 16 39 48 92 7 47 38 36 4 52 69 85 84 97 65 19 64 8 95 36 3 94 67 88 61 14 28 10 53 64 9 39 47 1 73 83 30 55 14 30 65 31 32 34 75 7 47 92 12 67 71 24 92 89 17 87 95 49 51 94 21 27 93 2 81 98 94 50 9 35 49 71 
58 84 68 70 86 26 62 21 16 1 38 22 5 59 87 92 89 70 52 90 65 88 36 27 68 70 71 88 6 36 34 81 60 25 94 21 82 63 52 34 37 12 4 41 99 28 62 46 81 98 6 44 68 14 90 17 67 91 51 13 6 36 57 4 95 60 9 63 65 10 55 55 47 31 15 26 26 24 40 41 56 7 86 20 11 51 28 10 45 59 53 69 60 65 92 73 45 29 65 25 
89 79 92 60 91 84 54 62 40 95 41 57 77 12 75 14 27 49 89 81 25 87 91 46 9 7 92 64 94 28 81 14 78 27 46 17 7 19 30 36 65 77 19 67 77 32 92 84 81 37 83 88 94 4 42 37 52 75 75 13 24 52 29 3 29 19 34 98 40 37 67 39 71 23 89 59 59 63 21 8 15 96 9 97 6 76 77 6 98 49 81 24 21 28 16 82 59 69 12 96 
