jobs 100
stage 8
machines 2 1 2 3 2 2 5 4 
*Pro_req*
2 1 1 1 1 2 1 2 2 2 2 2 1 2 1 2 1 2 1 1 1 1 1 2 2 1 2 2 1 1 1 1 2 1 2 2 1 1 2 1 1 1 1 1 2 2 2 2 1 1 2 2 1 2 1 1 2 1 2 2 1 1 2 2 1 1 2 1 1 1 1 1 1 2 1 2 1 2 1 1 2 2 1 1 1 2 2 2 1 2 2 1 1 1 2 2 2 2 1 1 
1 1 1 1 1 1 1 1 1 1 1 1 1 1 1 1 1 1 1 1 1 1 1 1 1 1 1 1 1 1 1 1 1 1 1 1 1 1 1 1 1 1 1 1 1 1 1 1 1 1 1 1 1 1 1 1 1 1 1 1 1 1 1 1 1 1 1 1 1 1 1 1 1 1 1 1 1 1 1 1 1 1 1 1 1 1 1 1 1 1 1 1 1 1 1 1 1 1 1 1 
2 2 2 1 1 2 2 2 1 1 1 2 2 1 2 1 2 1 2 2 2 2 1 1 1 1 2 1 1 1 1 1 2 1 1 2 1 1 1 1 1 2 2 2 1 1 1 1 2 1 1 2 2 2 2 2 2 2 1 2 1 2 2 1 2 2 1 2 1 2 2 2 1 1 1 2 1 1 2 1 1 2 2 2 2 2 2 2 1 2 2 1 2 1 1 2 1 2 2 2 
2 3 3 2 3 3 3 1 1 1 2 2 3 3 3 2 2 3 1 1 1 3 2 1 3 1 3 1 2 2 3 2 3 1 1 2 1 2 2 3 1 3 1 1 2 1 2 3 1 1 2 1 1 3 1 2 2 2 3 3 1 1 2 2 3 1 1 3 2 3 3 2 3 1 2 2 1 1 2 2 2 3 3 2 2 1 2 1 1 1 3 3 2 1 1 2 3 3 1 3 
1 1 1 1 2 2 2 2 1 2 1 2 2 1 1 1 1 2 2 1 2 2 2 2 2 1 2 2 1 1 1 2 2 2 2 1 1 1 2 1 1 1 2 1 2 2 2 1 2 2 1 1 1 2 1 1 2 1 1 2 1 1 2 2 2 2 1 2 1 2 1 2 2 1 2 1 2 2 2 2 1 1 2 1 2 1 1 1 1 1 2 1 1 1 1 2 2 1 1 1 
1 2 2 1 2 2 1 1 2 1 1 1 1 1 2 2 2 1 1 1 1 1 1 2 1 2 2 1 1 2 1 1 2 2 1 1 2 1 1 1 2 2 2 1 2 1 1 2 1 1 1 2 2 2 2 2 2 1 1 2 2 2 2 1 1 1 2 2 1 1 2 1 1 1 1 2 1 2 2 2 2 2 1 1 2 2 1 2 1 1 2 2 1 2 1 1 1 2 1 1 
5 3 2 4 3 1 1 5 5 1 2 2 2 4 5 2 2 2 3 5 4 2 3 5 5 4 4 3 2 4 5 1 1 2 1 5 4 1 2 4 2 1 2 4 4 4 1 4 1 2 2 5 5 2 1 4 5 2 1 5 1 5 4 4 2 1 1 1 1 5 5 4 1 4 4 5 3 4 5 2 2 5 5 2 1 5 5 3 4 4 2 4 1 5 3 5 3 5 4 3 
3 4 1 2 2 4 2 4 3 1 4 4 4 2 4 4 4 3 1 4 4 1 2 2 4 4 2 2 2 2 2 2 2 2 3 2 4 3 4 1 2 4 4 1 2 4 2 1 1 3 1 3 1 1 2 2 2 1 1 1 1 4 2 1 3 4 2 4 4 4 3 3 1 1 3 1 1 2 1 1 1 4 4 3 4 1 1 3 3 2 2 3 3 2 4 3 2 1 4 1 
*Pro_time*
63 25 22 14 11 2 49 60 21 31 35 35 25 34 75 37 13 12 13 96 37 98 4 41 85 44 25 56 24 16 72 95 80 49 35 91 15 82 50 3 6 51 58 55 55 13 78 14 39 99 2 25 45 9 11 28 31 17 28 95 44 24 78 82 73 48 5 34 20 45 65 55 26 54 87 6 57 95 45 15 25 34 12 41 57 67 21 74 61 52 31 83 3 72 36 85 6 60 63 23 
2 1 13 32 79 84 80 31 40 78 86 74 75 6 61 93 87 41 42 75 15 77 23 2 73 62 93 94 74 99 29 96 89 79 22 33 47 48 54 53 86 87 35 75 50 100 52 1 36 48 92 71 63 64 41 30 80 16 30 13 40 37 38 25 35 93 25 33 69 34 76 53 38 90 92 39 33 11 22 51 79 85 61 4 97 52 98 32 90 80 19 58 72 39 8 57 42 13 21 68 
10 96 18 55 17 46 97 19 80 87 19 29 26 40 58 10 48 21 44 77 71 91 57 76 75 34 49 53 2 44 37 42 93 76 76 21 47 85 90 39 77 13 62 29 51 32 63 16 32 91 46 42 3 98 75 21 78 20 99 76 22 42 22 27 51 89 37 21 4 53 70 39 63 28 1 41 35 52 76 69 75 24 50 24 7 43 66 94 5 83 68 33 28 53 83 70 61 66 41 45 
63 99 2 90 34 10 39 88 71 80 17 11 12 8 100 46 68 57 37 76 56 15 28 14 91 71 86 67 7 27 9 8 61 66 44 90 93 1 15 59 36 50 90 84 11 80 53 27 71 96 5 61 23 85 33 76 51 70 30 92 46 1 9 27 79 64 59 84 26 65 23 79 14 18 92 79 81 23 9 12 23 46 49 44 5 18 65 77 21 1 29 32 60 65 67 5 20 30 35 64 
45 30 64 94 45 64 29 69 83 83 14 31 66 99 80 88 19 65 17 16 32 49 29 35 49 69 32 22 10 29 77 90 3 60 86 5 99 63 73 73 94 81 50 96 85 95 3 15 55 40 70 39 47 7 55 13 86 57 64 85 2 11 99 85 20 67 69 68 64 33 69 1 70 12 87 62 18 12 15 81 7 95 41 68 83 64 76 52 33 46 57 35 48 28 3 27 23 85 63 3 
35 64 64 25 26 96 55 14 53 75 28 74 31 17 92 99 37 17 50 15 1 6 37 70 71 25 34 91 87 28 3 94 71 26 37 6 94 92 12 81 60 14 74 71 13 74 61 66 22 55 64 54 10 78 74 78 85 16 22 3 20 16 12 47 3 50 66 2 65 19 2 4 28 18 94 1 58 77 70 1 66 90 51 93 17 68 79 79 23 60 89 39 80 33 84 71 91 34 69 48 
88 100 79 17 49 14 17 59 58 64 91 85 38 58 72 99 75 20 97 59 89 20 67 70 85 44 47 39 92 5 26 78 36 82 4 63 82 87 63 16 36 18 40 36 21 68 55 26 99 18 31 69 34 18 13 30 21 95 74 3 89 49 39 5 97 62 88 84 69 33 18 97 81 99 68 78 48 96 97 82 28 57 81 99 100 63 45 3 62 25 95 80 81 56 94 3 7 16 88 39 
65 8 56 4 61 36 61 31 34 44 64 92 36 1 7 96 55 37 55 12 39 23 90 92 47 96 41 44 100 97 48 80 40 34 19 41 86 23 77 32 87 27 80 22 63 59 87 12 75 1 53 71 9 79 22 54 60 38 73 67 87 42 3 74 54 64 32 12 1 33 31 64 77 53 20 8 85 62 18 57 67 69 92 70 85 15 2 5 93 4 97 6 43 70 50 67 57 26 42 69 
