jobs 100
stage 8
machines 3 5 2 2 3 1 5 4 
*Pro_req*
3 1 1 1 2 2 2 3 1 3 1 1 3 1 1 1 1 3 1 3 3 3 3 2 1 1 3 1 2 1 2 2 2 3 2 2 2 2 1 1 2 3 2 3 1 1 2 2 3 1 2 2 1 1 1 3 1 2 3 1 1 1 2 1 3 1 1 1 3 3 3 3 1 1 2 3 3 3 1 3 1 2 1 3 3 3 1 2 2 3 3 2 1 1 2 1 2 1 2 1 
2 4 4 3 1 1 1 2 5 5 3 4 2 3 5 1 4 2 5 4 1 2 3 5 2 3 5 4 3 2 5 3 5 3 2 4 2 2 2 1 1 1 5 4 3 4 2 3 1 4 4 3 4 1 4 2 3 4 5 2 4 5 5 5 5 3 4 3 2 2 1 2 3 1 3 3 2 2 1 3 3 1 1 4 2 4 3 1 4 1 5 1 5 1 1 4 4 4 1 5 
1 2 1 2 2 1 1 2 2 1 2 2 2 1 1 1 2 1 2 2 2 2 2 2 1 2 2 1 1 2 2 2 2 2 1 2 1 1 2 1 1 1 1 2 2 1 2 1 2 1 1 1 1 2 2 1 2 2 1 2 2 2 1 1 1 2 2 1 2 1 2 1 1 1 2 2 2 2 1 2 2 2 2 1 1 1 2 1 1 1 2 1 1 2 1 1 1 1 2 1 
2 1 2 1 1 2 2 2 2 1 1 1 2 2 1 2 1 2 1 1 2 1 2 1 2 1 2 2 1 1 2 2 2 1 2 1 2 2 1 2 1 2 2 1 2 2 1 2 2 1 2 1 1 2 2 1 1 1 2 1 1 1 2 2 2 2 1 1 1 1 2 2 2 2 2 2 2 1 2 1 2 1 2 2 1 1 2 2 2 1 2 1 1 1 1 2 1 2 1 2 
1 2 2 2 3 3 3 2 1 3 3 1 1 3 3 3 2 2 3 3 2 3 3 2 1 3 3 1 1 2 3 3 3 1 2 3 3 1 1 2 3 1 2 1 1 3 3 1 1 2 1 2 2 3 2 3 1 1 3 1 2 2 2 1 2 1 2 3 2 1 2 2 2 1 3 3 3 2 2 2 3 2 2 1 1 3 2 1 3 2 1 3 1 3 3 1 2 1 1 1 
1 1 1 1 1 1 1 1 1 1 1 1 1 1 1 1 1 1 1 1 1 1 1 1 1 1 1 1 1 1 1 1 1 1 1 1 1 1 1 1 1 1 1 1 1 1 1 1 1 1 1 1 1 1 1 1 1 1 1 1 1 1 1 1 1 1 1 1 1 1 1 1 1 1 1 1 1 1 1 1 1 1 1 1 1 1 1 1 1 1 1 1 1 1 1 1 1 1 1 1 
4 4 1 3 2 5 5 4 4 2 5 5 5 2 3 1 5 1 5 5 1 1 4 1 4 3 5 4 1 4 4 2 4 1 1 5 4 4 3 3 5 1 4 2 2 4 5 1 5 5 1 2 5 3 3 4 1 2 1 1 3 2 3 4 3 3 5 5 1 4 2 1 4 3 3 2 2 5 3 1 4 5 1 5 5 4 3 5 3 2 5 5 5 2 3 2 2 5 4 3 
1 2 4 4 4 3 1 4 2 4 3 1 3 2 1 1 2 2 4 3 1 1 3 2 2 2 2 1 2 4 1 4 4 2 2 3 1 1 3 4 1 4 2 1 1 1 1 1 3 2 2 1 2 2 2 2 1 3 2 2 2 1 4 2 3 4 2 1 3 3 1 3 3 3 4 2 2 3 3 4 4 4 1 1 3 4 1 4 1 1 1 1 1 4 1 4 2 2 4 2 
*Pro_time*
86 49 67 51 17 5 62 49 76 2 17 92 82 49 46 34 7 39 52 59 24 81 47 91 85 47 47 83 42 50 23 42 100 67 65 86 36 22 49 56 56 60 49 68 99 74 44 20 60 76 37 93 50 32 28 8 45 57 30 79 67 98 39 56 99 36 14 29 16 94 65 40 6 2 95 17 28 41 36 78 47 37 76 46 50 100 44 3 45 19 72 26 9 46 20 55 88 97 48 5 
6 69 44 63 69 15 23 91 89 52 68 72 54 55 30 31 37 2 26 3 98 47 9 29 100 87 26 37 58 18 8 52 25 71 85 44 37 32 26 71 71 50 97 86 73 26 10 12 77 12 4 66 14 60 69 60 60 82 48 77 8 65 74 3 26 94 43 87 17 22 80 5 47 60 62 6 36 83 36 7 67 33 59 26 29 15 45 59 65 15 66 12 65 24 98 32 93 56 29 11 
5 97 73 1 13 16 86 29 30 38 75 31 19 85 42 4 47 11 32 3 96 94 31 44 94 46 5 79 73 62 74 13 52 14 60 85 20 85 28 62 91 24 76 20 19 45 54 95 66 64 100 53 35 44 17 24 70 80 70 45 18 96 51 26 8 44 78 6 69 31 29 20 45 78 100 65 61 92 78 92 15 47 43 88 95 89 91 70 66 94 72 75 19 52 99 20 29 91 51 4 
85 3 22 35 71 41 63 35 37 31 99 91 73 6 35 76 86 27 83 32 47 67 85 16 28 89 19 61 15 64 52 82 23 2 98 49 40 13 100 95 94 91 1 41 82 69 37 81 62 96 52 32 23 56 63 58 8 31 37 72 85 94 45 86 6 72 16 87 3 24 68 53 89 63 28 4 41 18 34 19 46 58 29 77 24 9 64 31 90 84 92 87 71 64 95 100 87 23 38 68 
89 73 54 18 76 30 22 26 55 18 81 50 54 23 76 43 73 18 46 23 8 19 89 35 33 73 74 52 92 59 1 57 67 89 9 82 91 8 29 66 12 78 6 37 12 27 90 38 75 85 36 22 44 31 75 50 83 76 52 6 26 45 52 64 66 38 27 78 100 30 70 3 77 6 92 43 82 87 73 93 24 96 93 32 94 75 44 75 75 47 86 56 66 48 1 60 41 57 53 3 
8 84 64 56 81 91 58 50 31 25 31 55 95 19 1 2 63 90 84 69 57 28 81 5 30 90 31 5 68 46 30 71 17 29 82 77 34 12 40 42 89 50 28 16 61 99 94 15 42 38 67 89 24 86 79 76 34 76 12 14 57 58 83 72 26 14 50 84 91 27 47 51 99 99 62 54 94 75 21 69 4 61 71 62 83 63 17 72 23 60 60 6 10 44 6 15 18 70 50 48 
3 76 99 100 3 55 65 49 64 55 30 81 77 42 1 81 79 32 5 47 16 73 57 82 26 24 91 34 24 33 37 68 91 5 48 36 38 44 53 90 21 77 47 67 35 10 48 9 39 11 75 83 14 75 6 34 88 59 46 27 58 36 83 98 12 30 45 74 94 19 71 51 87 17 18 60 14 77 70 53 41 62 52 7 85 45 11 96 43 64 63 37 33 58 30 25 49 31 73 46 
70 49 54 46 5 98 40 59 36 99 64 80 95 29 90 58 1 7 11 63 60 84 24 76 91 43 15 54 2 8 54 43 9 85 52 82 69 41 75 53 75 89 74 48 55 33 46 12 90 48 65 55 41 61 38 87 58 56 94 24 71 56 98 100 46 85 16 20 74 58 46 10 86 46 73 40 75 74 56 2 35 40 26 5 89 35 14 57 89 91 32 6 55 77 89 36 15 15 5 100 
