jobs 100
stage 8
machines 1 2 4 5 1 1 4 5 
*Pro_req*
1 1 1 1 1 1 1 1 1 1 1 1 1 1 1 1 1 1 1 1 1 1 1 1 1 1 1 1 1 1 1 1 1 1 1 1 1 1 1 1 1 1 1 1 1 1 1 1 1 1 1 1 1 1 1 1 1 1 1 1 1 1 1 1 1 1 1 1 1 1 1 1 1 1 1 1 1 1 1 1 1 1 1 1 1 1 1 1 1 1 1 1 1 1 1 1 1 1 1 1 
1 2 2 2 1 2 2 1 2 1 2 1 2 1 1 1 1 2 1 1 1 2 1 2 2 2 2 1 1 2 2 1 1 2 2 1 2 2 1 2 1 2 2 2 2 2 2 1 1 2 1 1 2 1 1 2 2 1 2 2 1 2 1 2 2 2 2 1 1 1 1 2 2 1 2 2 2 2 2 2 2 1 1 1 2 2 2 2 2 1 1 2 1 1 2 1 1 1 2 1 
3 1 2 3 4 1 1 4 1 3 3 1 3 1 4 2 2 3 4 2 3 3 2 3 3 1 1 2 2 3 4 1 2 2 4 3 2 4 2 2 3 1 4 1 1 1 1 4 3 2 1 2 3 1 2 2 3 1 2 3 3 3 4 4 2 1 1 3 1 3 1 2 1 2 3 3 2 4 1 2 3 4 3 2 3 2 3 3 3 1 4 4 1 1 3 4 2 3 1 4 
5 2 3 4 4 3 4 2 2 1 2 4 2 3 5 1 3 5 5 4 4 1 1 2 1 5 2 2 1 4 2 4 3 5 4 4 2 5 2 5 2 5 5 3 4 1 3 1 4 5 2 5 1 1 5 4 2 3 5 2 5 1 2 4 4 4 4 1 3 4 4 1 5 2 5 4 4 3 3 4 5 5 4 2 4 3 3 2 1 2 4 2 1 2 1 3 5 4 2 1 
1 1 1 1 1 1 1 1 1 1 1 1 1 1 1 1 1 1 1 1 1 1 1 1 1 1 1 1 1 1 1 1 1 1 1 1 1 1 1 1 1 1 1 1 1 1 1 1 1 1 1 1 1 1 1 1 1 1 1 1 1 1 1 1 1 1 1 1 1 1 1 1 1 1 1 1 1 1 1 1 1 1 1 1 1 1 1 1 1 1 1 1 1 1 1 1 1 1 1 1 
1 1 1 1 1 1 1 1 1 1 1 1 1 1 1 1 1 1 1 1 1 1 1 1 1 1 1 1 1 1 1 1 1 1 1 1 1 1 1 1 1 1 1 1 1 1 1 1 1 1 1 1 1 1 1 1 1 1 1 1 1 1 1 1 1 1 1 1 1 1 1 1 1 1 1 1 1 1 1 1 1 1 1 1 1 1 1 1 1 1 1 1 1 1 1 1 1 1 1 1 
4 1 1 3 1 1 2 4 2 3 2 3 1 1 1 2 2 1 1 2 1 3 3 2 4 3 4 4 1 4 3 3 1 4 3 4 4 2 2 1 1 2 3 4 1 1 4 2 2 3 2 3 1 2 1 3 4 2 4 4 4 1 2 4 3 1 4 1 4 2 3 3 4 1 1 4 2 1 4 3 2 1 3 4 4 1 4 1 4 1 3 2 4 2 2 3 2 3 2 4 
1 5 2 1 2 5 4 3 4 3 1 1 5 1 5 1 4 2 4 1 4 1 5 4 5 3 5 2 4 5 5 5 1 4 1 1 4 3 2 2 1 2 3 3 3 4 3 2 5 4 2 2 2 1 2 5 5 1 1 1 1 2 3 2 5 5 1 3 3 2 4 1 4 1 2 2 2 5 2 2 3 2 3 5 4 3 4 4 2 1 4 5 1 2 5 2 2 3 5 3 
*Pro_time*
90 39 51 35 53 99 66 32 75 89 43 86 82 83 94 98 67 69 100 93 96 40 94 39 70 86 76 82 51 8 18 28 34 7 42 66 7 21 49 80 22 62 25 83 33 79 75 77 87 79 21 17 70 95 52 41 28 46 62 93 73 85 19 20 48 17 13 63 65 51 84 1 62 82 54 66 26 56 83 12 69 38 38 58 46 37 45 31 55 82 34 56 36 81 47 76 71 15 17 76 
31 96 18 8 43 97 78 48 92 42 29 81 24 61 55 94 99 5 63 68 40 8 73 56 69 30 99 29 72 33 7 66 94 56 54 80 9 79 1 51 30 31 77 34 46 60 41 54 86 46 5 62 6 40 32 90 3 71 25 64 80 70 59 21 20 11 34 88 12 69 74 12 43 1 74 69 79 53 44 67 3 96 45 72 78 86 14 65 94 41 40 34 74 47 100 6 56 73 47 55 
77 20 64 52 40 91 32 65 90 69 89 57 42 78 73 31 23 75 85 78 82 83 48 62 49 88 17 16 79 81 76 58 28 9 92 94 14 86 89 41 57 1 98 40 36 36 3 87 19 78 38 33 24 33 5 68 71 39 31 40 49 92 79 19 3 76 18 38 18 65 7 21 43 87 46 91 16 73 88 74 49 84 62 23 58 72 95 6 20 93 45 74 70 100 79 44 69 19 88 73 
23 96 24 89 5 19 72 56 18 73 58 65 40 14 63 99 70 47 9 46 90 51 100 38 45 54 88 26 79 85 85 93 27 68 97 37 62 23 77 97 54 91 11 8 65 27 66 89 50 89 2 49 6 16 75 39 34 36 57 37 74 87 82 8 63 84 80 30 51 69 90 100 45 66 85 34 82 52 41 80 75 47 94 23 52 24 46 28 68 54 82 52 23 24 56 68 77 41 99 66 
30 100 33 35 83 67 40 14 7 37 41 78 10 68 32 35 38 3 22 4 13 37 78 14 14 77 42 26 35 57 81 47 37 88 68 47 67 83 50 50 79 42 74 71 14 13 81 63 69 66 30 76 88 39 28 92 7 72 23 41 42 36 51 90 48 32 50 76 43 17 98 45 45 22 54 67 16 6 68 75 3 60 11 57 97 96 50 15 28 59 66 84 46 95 84 58 79 58 68 80 
20 39 12 41 19 64 65 47 74 85 20 83 81 54 52 73 84 17 48 42 3 45 97 13 87 97 43 55 32 11 14 19 15 19 97 11 69 54 12 77 52 71 99 99 57 86 71 13 86 40 94 38 77 18 81 97 6 59 88 40 78 24 68 50 4 79 85 41 26 91 13 59 82 93 34 49 38 63 62 53 78 58 54 91 18 13 49 41 50 68 69 9 35 83 85 84 31 81 17 91 
17 40 10 93 96 22 22 87 61 3 40 74 52 96 5 71 62 64 24 45 79 57 56 5 47 23 10 78 70 69 64 26 12 79 15 55 34 74 65 6 32 61 45 43 2 59 54 38 11 97 45 3 79 91 38 68 56 61 18 4 75 20 65 66 63 73 23 6 21 74 69 11 78 57 79 62 87 11 47 58 33 53 74 88 32 3 7 99 39 69 95 21 19 98 60 60 32 66 95 28 
45 68 12 23 83 17 79 98 47 7 72 99 15 84 3 39 29 6 46 55 78 58 28 47 70 86 41 59 19 68 90 2 70 60 55 84 16 89 87 100 22 96 79 44 26 84 22 11 86 45 91 92 25 85 61 75 47 28 91 1 91 14 22 23 59 14 34 87 26 91 96 84 82 14 53 66 38 4 30 5 60 30 39 3 55 7 83 63 10 22 91 35 71 97 41 6 5 11 34 84 
