jobs 100
stage 8
machines 5 1 4 1 3 3 1 2 
*Pro_req*
5 2 4 2 4 4 5 4 2 2 2 5 1 5 5 2 3 2 4 5 3 2 2 5 2 5 4 1 1 3 4 1 2 2 3 5 3 3 2 5 1 3 2 5 3 5 5 1 2 5 5 5 4 4 3 5 5 2 1 2 1 2 1 3 2 1 4 4 4 3 1 1 4 1 5 1 4 5 4 4 5 5 5 1 2 4 1 3 1 1 2 3 1 3 3 1 4 3 1 2 
1 1 1 1 1 1 1 1 1 1 1 1 1 1 1 1 1 1 1 1 1 1 1 1 1 1 1 1 1 1 1 1 1 1 1 1 1 1 1 1 1 1 1 1 1 1 1 1 1 1 1 1 1 1 1 1 1 1 1 1 1 1 1 1 1 1 1 1 1 1 1 1 1 1 1 1 1 1 1 1 1 1 1 1 1 1 1 1 1 1 1 1 1 1 1 1 1 1 1 1 
3 4 2 3 4 2 1 4 3 4 3 3 4 4 2 3 1 4 3 3 1 1 3 1 4 4 2 3 3 1 3 3 3 1 4 4 3 2 2 2 4 1 3 4 2 3 3 4 3 4 4 2 1 2 1 1 2 2 4 4 2 1 1 3 2 1 1 4 4 2 1 1 3 3 2 1 3 4 3 4 4 2 4 1 1 4 4 2 3 1 2 1 2 1 3 3 4 3 2 4 
1 1 1 1 1 1 1 1 1 1 1 1 1 1 1 1 1 1 1 1 1 1 1 1 1 1 1 1 1 1 1 1 1 1 1 1 1 1 1 1 1 1 1 1 1 1 1 1 1 1 1 1 1 1 1 1 1 1 1 1 1 1 1 1 1 1 1 1 1 1 1 1 1 1 1 1 1 1 1 1 1 1 1 1 1 1 1 1 1 1 1 1 1 1 1 1 1 1 1 1 
1 3 1 2 3 3 3 2 3 2 3 3 2 2 2 1 2 2 2 1 2 1 1 3 1 2 1 1 1 2 3 1 1 3 3 2 2 1 1 1 3 1 3 1 1 2 2 3 2 2 1 1 1 1 1 1 1 3 2 1 1 1 1 3 3 3 1 2 3 1 3 3 3 1 3 2 2 1 3 2 2 2 2 3 2 1 2 3 3 1 2 1 2 3 1 1 1 3 2 2 
2 2 1 1 2 2 1 1 3 2 2 1 2 1 1 3 2 1 1 3 1 3 3 1 3 2 2 3 1 1 3 3 3 2 3 1 2 2 2 1 2 1 1 1 3 2 2 2 1 3 3 1 2 2 3 1 2 1 1 2 3 2 3 3 1 2 2 3 3 1 3 1 1 3 3 2 1 2 1 1 3 2 2 3 1 1 3 1 3 3 2 3 1 2 1 2 3 3 2 1 
1 1 1 1 1 1 1 1 1 1 1 1 1 1 1 1 1 1 1 1 1 1 1 1 1 1 1 1 1 1 1 1 1 1 1 1 1 1 1 1 1 1 1 1 1 1 1 1 1 1 1 1 1 1 1 1 1 1 1 1 1 1 1 1 1 1 1 1 1 1 1 1 1 1 1 1 1 1 1 1 1 1 1 1 1 1 1 1 1 1 1 1 1 1 1 1 1 1 1 1 
2 1 1 1 2 1 2 2 2 1 1 1 1 1 1 1 2 1 2 1 1 1 2 2 2 1 1 1 1 2 2 1 1 2 2 2 2 1 1 1 2 1 2 2 2 1 1 2 2 1 2 1 2 1 2 2 2 1 2 2 1 1 2 1 2 1 2 2 1 1 2 2 2 2 1 2 2 1 1 1 2 2 1 2 2 2 1 1 1 1 1 1 2 1 2 2 2 2 2 2 
*Pro_time*
76 19 43 77 55 54 90 77 12 95 98 47 45 53 10 49 10 22 43 43 46 2 6 98 2 44 10 39 36 64 11 52 21 66 57 55 41 78 32 39 83 87 32 74 38 75 12 16 48 34 45 86 70 22 2 59 40 35 63 50 26 91 2 86 81 27 71 32 34 14 2 35 37 17 58 63 52 78 42 87 43 50 41 48 83 82 98 16 1 53 19 58 60 14 52 27 91 79 2 40 
1 18 98 2 11 23 83 72 78 62 91 45 63 24 45 100 33 71 2 54 95 18 65 59 86 93 19 88 11 66 53 90 55 99 69 93 27 9 20 57 53 3 85 3 44 76 68 75 12 23 86 98 12 11 81 29 82 73 98 95 55 18 53 97 63 22 49 39 2 44 65 36 29 31 7 98 47 18 11 49 57 24 71 68 50 17 78 68 59 27 57 85 67 41 4 96 81 36 32 11 
61 97 17 30 24 66 63 73 32 82 27 90 25 6 64 20 59 98 10 13 75 29 38 11 51 19 68 68 70 21 13 67 95 65 23 13 81 52 22 10 79 87 67 52 24 86 33 6 64 54 84 26 6 29 78 85 85 99 78 29 40 8 22 46 7 83 95 39 41 86 2 33 53 59 25 60 91 27 19 80 33 100 99 6 49 100 51 12 96 7 7 1 66 64 86 31 20 90 60 57 
40 37 8 57 79 9 66 75 86 13 16 1 2 40 1 33 91 9 8 79 46 36 20 34 37 21 56 3 50 59 88 68 26 57 99 26 48 31 7 53 3 40 35 56 64 68 35 83 84 34 4 87 85 64 31 43 88 2 29 66 64 74 67 34 33 92 97 65 19 9 79 38 7 44 72 72 75 81 75 13 72 16 5 71 54 91 54 82 55 58 20 40 70 90 38 17 15 31 89 92 
38 23 34 6 94 95 73 43 42 93 95 3 42 25 78 62 54 84 5 86 62 12 18 19 46 98 1 74 69 48 86 100 59 57 32 67 72 54 36 48 86 38 83 47 84 44 39 72 45 16 6 10 84 92 88 47 65 20 92 82 68 76 56 90 65 53 33 4 77 79 18 3 33 83 92 35 67 76 89 22 82 6 99 39 55 31 80 78 89 88 8 64 55 46 60 70 79 35 98 1 
20 93 73 84 22 92 54 33 6 13 2 74 36 41 80 32 75 54 88 52 68 4 3 31 20 21 40 14 47 68 13 97 51 79 96 63 41 97 30 77 33 65 44 48 43 89 64 67 53 36 53 27 7 71 61 66 8 2 84 6 93 92 30 62 69 15 77 62 45 5 44 72 98 25 72 87 24 53 3 61 17 48 3 30 3 24 13 67 9 77 11 38 10 46 7 7 42 30 56 56 
30 48 60 28 81 45 51 23 87 70 88 40 8 29 75 45 88 93 39 49 24 8 72 45 48 62 83 26 67 47 23 55 54 4 31 84 39 41 45 5 36 44 30 55 81 100 53 25 90 19 50 31 60 20 12 84 81 1 84 14 30 28 91 6 9 5 28 26 13 1 30 69 21 81 52 65 40 12 12 100 57 50 13 56 20 27 66 59 27 34 18 12 53 66 63 23 62 38 39 43 
5 87 96 30 79 34 34 98 78 4 29 17 79 45 3 13 27 88 19 27 83 58 23 61 15 92 73 64 34 82 5 24 23 16 32 58 76 69 90 44 15 57 98 81 53 96 84 65 3 88 33 24 86 85 19 17 58 76 64 13 47 6 82 31 93 89 91 42 8 76 82 32 61 35 15 26 4 35 54 92 96 91 26 73 30 48 52 6 67 26 54 7 8 73 89 82 86 43 81 44 
