jobs 100
stage 8
machines 5 5 1 4 3 3 4 5 
*Pro_req*
5 3 5 2 4 2 3 5 3 1 3 2 4 4 5 1 4 3 1 5 2 5 1 3 3 2 1 4 2 4 1 4 4 2 5 5 5 2 1 1 1 4 3 3 5 4 1 4 4 2 2 2 2 3 5 3 1 5 4 4 5 3 4 5 5 2 2 3 1 5 5 5 4 3 1 5 5 5 3 2 2 1 3 2 3 5 5 5 3 5 1 3 1 4 5 4 5 1 5 5 
3 5 5 1 2 2 3 3 5 3 4 1 2 1 1 3 5 2 3 5 5 5 4 1 1 5 5 5 1 5 1 1 5 1 3 5 5 4 1 5 3 4 1 3 5 2 5 1 2 5 2 5 3 3 1 3 4 1 5 1 3 5 1 2 5 5 2 3 2 1 2 2 3 5 3 2 5 4 3 2 2 2 4 1 3 4 3 5 5 2 4 5 5 3 2 2 5 5 2 1 
1 1 1 1 1 1 1 1 1 1 1 1 1 1 1 1 1 1 1 1 1 1 1 1 1 1 1 1 1 1 1 1 1 1 1 1 1 1 1 1 1 1 1 1 1 1 1 1 1 1 1 1 1 1 1 1 1 1 1 1 1 1 1 1 1 1 1 1 1 1 1 1 1 1 1 1 1 1 1 1 1 1 1 1 1 1 1 1 1 1 1 1 1 1 1 1 1 1 1 1 
1 2 1 1 2 4 2 4 4 4 1 2 3 3 1 1 4 4 4 1 2 1 4 4 2 2 4 4 3 3 3 4 1 4 4 2 2 4 1 1 1 3 2 3 3 2 1 2 4 3 2 3 4 2 3 2 4 1 2 3 3 2 4 4 4 2 1 3 3 2 2 2 1 4 2 4 2 2 3 2 2 1 1 4 3 2 1 1 2 3 1 3 3 2 3 3 2 2 3 3 
2 2 3 2 3 2 3 1 1 2 1 2 3 1 1 1 2 3 3 3 1 2 3 1 2 2 2 1 1 2 1 1 3 2 2 2 2 1 1 2 3 3 2 2 2 1 2 1 2 2 2 3 2 2 1 3 2 2 3 1 3 2 3 2 3 1 2 1 2 1 2 2 1 1 1 1 1 3 2 1 3 2 3 2 2 3 1 3 1 1 3 1 2 1 1 3 1 2 1 1 
1 2 2 2 3 1 3 1 3 3 3 2 2 2 2 2 1 3 1 3 2 3 1 3 3 1 3 1 3 1 1 1 1 1 3 1 3 1 2 1 3 1 1 3 1 3 1 3 1 2 1 3 3 1 1 3 1 2 3 2 1 3 3 1 1 2 1 3 2 2 1 1 2 1 1 1 3 1 3 1 2 2 1 3 1 3 3 2 3 3 1 2 3 3 2 2 2 3 1 1 
4 3 4 3 2 4 2 3 3 2 3 4 1 3 2 2 2 2 4 2 4 3 4 4 3 4 3 3 3 3 2 2 3 2 3 3 4 3 3 1 1 3 1 1 2 1 2 1 3 2 4 1 2 4 3 1 2 2 2 1 1 2 2 1 4 1 1 4 3 2 3 4 2 3 2 4 1 3 3 3 4 2 1 3 4 4 3 3 3 3 2 4 3 2 2 2 2 2 3 3 
4 5 4 5 4 3 5 3 4 2 3 3 3 2 2 5 1 1 2 1 4 2 3 4 2 4 2 3 3 2 5 4 5 3 4 1 2 5 4 1 4 5 3 5 1 5 4 2 1 3 5 2 2 5 2 4 4 2 5 2 1 3 4 2 1 4 5 4 3 5 4 4 5 3 5 2 5 2 5 4 4 5 1 2 5 5 1 1 3 4 3 5 4 3 5 3 5 4 3 2 
*Pro_time*
17 20 62 85 59 43 57 87 44 20 98 16 43 74 15 83 55 4 92 95 65 50 46 3 65 33 69 68 17 80 26 43 70 40 14 29 32 47 13 76 7 31 68 61 64 88 96 60 35 68 29 84 42 29 70 10 80 24 32 95 97 64 16 37 2 8 2 66 30 56 82 97 41 28 100 94 89 73 63 42 63 25 94 68 9 61 99 90 48 69 50 88 95 96 98 63 85 51 86 1 
94 67 92 61 60 21 22 58 99 1 25 75 37 46 17 83 46 79 86 83 82 6 98 59 14 85 20 70 31 59 77 48 90 77 80 89 98 42 51 25 98 100 98 34 41 34 74 86 31 56 8 42 37 19 100 94 30 40 70 55 89 81 51 59 43 54 60 36 53 39 8 14 14 93 69 9 67 31 42 3 71 55 98 48 30 87 99 20 28 66 30 70 4 93 54 13 10 77 56 61 
92 5 10 41 6 47 56 10 91 97 60 75 69 4 23 74 90 31 64 17 47 1 8 85 33 11 5 87 80 9 26 17 21 34 22 70 1 89 15 22 20 7 71 97 97 62 29 37 47 34 47 61 86 83 47 97 86 56 70 84 43 61 93 4 99 23 9 69 12 29 33 31 63 89 80 5 13 4 87 87 99 11 53 80 40 100 31 3 91 93 11 31 9 66 8 86 31 80 28 93 
58 64 19 27 40 18 16 82 78 19 65 71 96 46 38 69 16 15 4 100 58 47 53 71 12 64 44 76 1 67 94 21 68 58 4 35 19 21 6 73 80 92 62 80 73 100 25 45 18 65 12 73 64 10 24 78 99 11 15 47 89 28 57 68 20 98 33 15 2 85 10 2 99 84 98 9 5 39 81 76 97 39 44 22 47 85 63 41 4 41 89 93 47 31 28 4 55 17 18 46 
51 85 39 95 19 74 1 55 69 56 14 58 20 53 49 82 93 9 38 96 52 95 33 72 28 69 91 55 23 78 8 68 75 9 66 70 26 45 59 66 40 37 60 24 98 13 100 91 70 8 55 65 31 47 90 46 81 40 58 91 100 69 100 8 45 55 61 10 46 66 94 58 100 2 51 98 71 38 26 100 13 42 49 21 94 24 15 51 14 73 27 27 72 73 60 64 62 86 93 45 
85 53 24 89 66 1 64 97 24 31 70 46 87 19 52 31 59 29 18 86 37 27 15 55 90 38 70 92 5 88 47 86 96 39 21 16 75 91 55 92 13 21 15 90 100 78 35 9 32 79 27 72 70 32 70 21 53 43 49 4 34 14 25 31 66 76 61 90 54 86 6 2 26 85 17 42 69 66 1 45 23 22 60 29 75 40 35 53 96 50 84 81 45 20 99 70 71 14 65 16 
58 65 75 100 55 64 38 14 43 33 86 71 94 36 16 20 76 44 17 61 7 9 96 56 78 90 61 80 77 21 88 76 44 28 70 54 38 83 20 69 41 88 73 85 2 58 17 89 38 33 45 35 29 83 6 80 27 56 42 66 81 42 88 9 5 23 41 94 82 95 46 58 72 49 36 16 52 81 70 60 28 75 8 92 84 50 71 52 76 84 66 41 13 86 90 92 77 26 61 42 
25 26 19 24 60 41 12 32 47 2 61 83 68 95 27 47 58 21 31 45 95 43 61 38 43 56 90 37 29 39 88 28 86 24 73 66 79 6 63 81 68 29 15 44 76 76 33 54 56 1 29 60 75 28 40 71 88 4 25 4 68 75 27 63 59 42 32 61 79 47 90 36 9 43 54 23 47 42 36 11 23 37 34 16 17 22 57 91 2 9 79 20 21 39 12 75 15 66 5 13 
