jobs 100
stage 8
machines 4 3 4 1 2 3 2 2 
*Pro_req*
3 1 4 2 4 3 2 2 2 2 3 3 4 4 4 4 4 2 1 2 3 2 3 2 3 1 2 2 1 2 4 1 1 4 3 3 2 1 4 4 3 1 2 3 1 1 3 3 1 3 4 1 2 4 2 2 2 3 1 2 2 4 2 3 3 3 4 2 1 3 1 1 3 4 1 1 4 4 3 3 2 2 4 3 1 4 4 3 1 3 4 4 2 4 2 2 3 3 2 3 
3 2 3 2 3 1 1 1 3 1 2 2 1 3 2 2 3 3 3 3 3 1 1 1 1 1 3 3 1 2 2 3 1 2 1 1 3 1 3 2 3 1 1 2 1 2 1 2 3 1 2 1 2 1 1 1 1 3 2 1 3 2 2 1 3 2 1 1 3 2 2 3 1 2 2 3 1 2 1 3 2 1 2 3 2 2 3 3 2 1 2 3 1 3 1 3 1 2 2 2 
1 3 4 4 2 4 1 4 3 1 1 2 1 2 2 3 1 3 4 3 4 1 2 1 2 4 4 4 3 4 2 4 2 4 2 4 3 1 3 2 4 1 1 3 3 2 1 1 3 1 1 1 4 3 2 1 3 1 3 3 4 4 3 3 3 3 4 3 3 4 4 2 4 4 3 4 3 2 4 1 2 1 1 2 4 4 1 1 1 3 1 3 1 2 4 2 4 1 3 3 
1 1 1 1 1 1 1 1 1 1 1 1 1 1 1 1 1 1 1 1 1 1 1 1 1 1 1 1 1 1 1 1 1 1 1 1 1 1 1 1 1 1 1 1 1 1 1 1 1 1 1 1 1 1 1 1 1 1 1 1 1 1 1 1 1 1 1 1 1 1 1 1 1 1 1 1 1 1 1 1 1 1 1 1 1 1 1 1 1 1 1 1 1 1 1 1 1 1 1 1 
1 2 1 1 1 2 1 2 1 2 2 2 2 2 2 1 2 1 1 1 2 2 1 1 2 1 1 1 1 1 2 1 2 1 1 1 2 2 1 1 1 2 2 2 2 1 1 1 1 2 2 1 2 2 2 2 2 2 2 1 2 1 1 2 2 1 1 1 1 1 2 2 2 2 2 2 1 2 1 2 1 1 1 1 2 2 1 1 2 2 1 2 2 1 1 2 1 2 1 2 
1 2 2 3 1 3 1 3 3 1 1 1 1 3 2 2 1 3 1 1 1 3 1 1 3 3 1 3 1 1 1 2 3 1 3 1 1 2 1 1 1 1 2 2 3 1 2 1 3 1 3 1 3 1 2 1 3 3 1 3 1 1 3 2 1 3 2 3 1 2 3 1 1 1 3 2 2 1 2 3 1 2 2 1 2 3 2 3 3 1 2 3 1 2 3 3 3 3 1 1 
1 2 2 1 2 2 2 2 1 1 1 2 1 2 2 2 1 1 1 2 1 1 1 2 2 2 1 2 2 1 1 2 2 1 1 1 1 2 1 2 1 2 1 2 2 2 1 1 2 2 1 2 1 1 2 1 1 2 1 2 1 1 2 2 1 2 1 1 2 1 2 2 2 2 2 2 2 1 2 1 2 2 2 2 2 1 1 1 1 1 1 1 1 1 1 2 2 1 2 1 
1 2 2 1 1 2 2 1 1 2 2 1 1 2 2 1 1 2 1 2 1 2 1 2 1 2 1 1 1 2 1 2 1 1 2 1 1 2 2 2 1 2 2 2 2 1 2 1 1 1 1 2 2 2 2 2 2 2 1 2 1 2 1 1 2 2 2 2 2 1 1 1 2 1 1 2 1 2 1 1 1 2 2 2 1 2 1 1 2 2 2 1 2 1 2 1 2 2 1 1 
*Pro_time*
92 9 50 14 42 2 76 27 28 2 18 90 80 32 32 71 97 19 97 18 64 76 54 68 14 88 57 23 48 88 38 99 71 81 39 25 21 57 58 20 62 3 36 40 44 74 47 32 16 1 34 66 12 77 86 87 26 87 28 100 45 9 21 73 20 46 50 83 58 87 61 45 71 90 81 64 35 18 85 42 97 26 56 2 96 56 93 89 97 49 54 24 43 30 1 99 73 57 21 75 
86 50 26 75 87 89 15 71 31 41 24 25 15 84 16 19 1 91 39 2 57 18 94 49 89 92 14 91 42 99 81 36 24 64 97 29 1 87 24 92 14 55 3 72 52 78 93 79 8 53 87 34 52 74 56 98 60 2 52 11 84 24 76 40 66 30 25 93 16 78 49 2 20 72 80 63 78 16 26 15 29 57 28 99 40 39 83 43 3 91 93 80 69 37 26 89 83 1 81 15 
18 44 62 68 76 25 49 9 70 34 36 78 30 79 87 21 41 65 82 75 42 84 49 33 62 45 5 28 16 98 46 24 74 76 8 75 97 100 97 25 49 47 31 72 19 15 58 38 57 35 1 39 36 32 100 27 42 10 96 84 10 48 24 43 5 66 98 74 73 37 32 61 11 29 52 34 45 11 6 86 19 39 87 75 70 28 16 32 78 61 31 96 36 54 17 89 24 33 58 65 
78 9 59 75 33 29 15 46 17 8 41 59 40 86 74 64 5 42 79 4 41 43 55 49 91 65 6 34 47 96 7 100 93 86 91 73 58 41 64 93 8 81 9 96 99 70 71 79 26 71 11 99 46 41 81 76 3 67 20 32 49 30 77 7 60 30 43 66 86 69 47 9 39 99 20 32 27 71 21 1 70 50 20 65 56 12 56 17 80 83 33 34 69 3 41 30 13 10 67 33 
38 20 22 43 58 5 32 8 61 22 85 30 92 3 74 22 100 94 97 1 97 28 66 27 51 48 92 70 71 52 66 31 15 31 15 33 93 47 59 31 46 52 21 51 93 59 21 18 35 64 19 89 18 79 63 6 4 98 15 96 4 98 61 43 52 95 65 95 48 37 71 91 93 53 48 21 95 63 70 38 33 88 16 59 82 36 74 17 14 42 55 87 20 68 43 87 82 77 51 6 
14 88 72 74 98 70 63 15 12 96 98 19 89 90 76 3 67 58 97 43 74 91 88 50 99 68 77 43 100 55 66 87 16 25 48 60 84 83 37 73 74 95 55 36 57 67 40 45 58 30 68 18 59 91 57 87 34 16 34 91 76 8 15 77 84 89 46 81 62 81 25 46 59 56 81 92 1 59 50 98 59 48 73 86 6 21 16 65 77 24 54 57 59 83 50 19 56 98 41 82 
9 86 37 27 66 94 19 26 36 6 70 96 27 72 32 26 29 55 56 13 7 16 62 40 93 72 76 71 58 4 40 42 62 92 54 82 26 24 82 53 46 4 48 5 18 50 64 78 17 67 56 94 14 33 80 79 43 19 32 26 7 40 69 97 33 23 13 96 64 82 64 88 80 7 26 10 64 93 69 97 1 68 2 36 63 22 16 63 24 48 76 97 65 10 73 65 56 25 58 70 
88 14 16 16 43 75 91 23 8 13 14 48 91 72 83 52 21 32 19 100 27 84 38 53 49 94 15 22 25 10 32 23 11 3 22 10 99 60 13 87 13 61 40 17 95 36 10 61 62 75 31 74 65 86 12 99 34 68 99 7 1 85 77 91 41 37 84 7 47 60 100 65 67 43 78 46 76 83 100 90 86 12 55 65 75 5 71 28 88 94 10 83 28 52 47 3 38 7 90 67 
