jobs 100
stage 8
machines 1 3 2 4 4 4 4 2 
*Pro_req*
1 1 1 1 1 1 1 1 1 1 1 1 1 1 1 1 1 1 1 1 1 1 1 1 1 1 1 1 1 1 1 1 1 1 1 1 1 1 1 1 1 1 1 1 1 1 1 1 1 1 1 1 1 1 1 1 1 1 1 1 1 1 1 1 1 1 1 1 1 1 1 1 1 1 1 1 1 1 1 1 1 1 1 1 1 1 1 1 1 1 1 1 1 1 1 1 1 1 1 1 
1 2 2 1 2 3 1 1 2 3 2 2 3 1 3 1 1 3 3 1 2 3 3 1 1 2 1 1 2 2 3 3 1 1 3 3 2 2 1 1 2 2 2 3 1 3 3 1 3 1 2 3 1 1 3 3 1 1 3 2 1 2 3 3 2 1 3 1 1 1 2 2 1 1 2 1 1 2 2 2 1 1 1 2 2 1 3 3 2 2 3 1 2 3 2 3 2 2 1 2 
1 2 2 2 2 2 1 2 2 1 1 1 1 2 2 1 2 2 2 2 1 2 1 1 2 1 1 2 2 2 1 2 2 2 1 1 2 1 1 2 2 1 2 2 2 2 1 2 2 1 1 1 2 1 1 1 2 1 1 1 2 2 2 2 1 2 1 1 2 2 1 1 1 2 2 1 1 2 2 2 2 1 2 2 1 1 2 2 1 2 1 1 1 1 2 2 2 1 1 1 
4 3 4 4 1 1 1 3 1 4 3 1 1 2 2 4 3 2 2 4 1 4 1 1 3 1 3 4 2 1 3 1 3 2 4 1 4 1 4 3 2 2 1 1 3 1 1 3 1 2 2 4 4 1 2 3 1 4 2 2 2 1 3 3 1 2 3 2 3 2 3 4 2 3 2 4 2 3 2 4 1 2 2 2 3 1 4 4 3 2 3 1 4 1 2 4 1 3 2 2 
4 1 1 3 4 3 2 1 4 4 1 2 4 3 1 3 2 2 4 4 2 4 1 3 2 3 3 3 3 1 3 3 2 4 1 4 3 3 1 1 3 4 3 4 1 4 1 1 3 3 3 4 1 1 4 3 2 3 3 1 1 1 4 3 1 1 3 4 3 3 1 1 2 1 3 2 2 4 2 3 4 2 4 4 2 4 4 2 2 2 3 1 1 3 3 3 4 2 2 1 
4 4 4 2 3 1 2 4 4 2 2 2 2 3 3 3 3 4 3 3 1 2 1 1 1 4 1 3 2 1 3 4 2 3 4 1 2 3 2 1 1 4 3 2 1 4 1 4 4 3 4 4 3 2 4 3 2 1 3 3 3 1 4 2 2 1 4 1 4 4 1 3 1 4 2 4 4 3 4 3 3 4 2 1 1 2 3 4 2 4 2 1 2 1 4 4 4 4 2 1 
4 4 3 4 3 2 4 3 4 3 1 4 2 4 2 3 3 2 1 3 1 4 1 4 1 2 3 1 4 3 3 2 2 2 4 2 1 3 1 4 4 3 4 3 2 2 1 3 1 2 2 4 1 2 2 3 2 3 4 4 1 2 1 2 2 1 3 4 1 4 1 3 2 4 3 4 1 1 4 1 2 3 1 4 1 2 2 3 3 1 4 3 1 2 3 1 1 3 2 4 
1 1 2 1 2 1 2 2 1 2 2 1 1 2 2 1 1 1 2 1 2 1 2 1 1 2 1 1 1 2 1 1 1 2 1 2 2 1 1 2 2 2 2 1 2 2 2 1 1 2 1 1 1 1 1 1 2 2 2 1 2 1 2 1 2 1 2 2 1 1 1 1 1 1 1 2 1 1 1 1 1 2 2 1 2 1 2 1 2 1 1 2 1 2 2 1 1 2 1 2 
*Pro_time*
16 17 12 97 79 19 25 58 91 70 33 8 99 69 65 97 39 47 62 17 58 99 98 78 2 69 88 92 8 62 16 88 14 91 96 97 77 90 33 66 94 51 86 2 29 77 67 40 62 46 42 99 19 59 39 68 11 42 100 43 54 55 30 43 100 38 50 41 68 70 86 96 29 59 49 20 55 68 58 55 34 62 72 25 96 86 49 5 50 6 5 84 73 89 64 97 70 21 48 91 
17 2 12 8 30 87 12 47 77 50 89 79 77 25 38 16 100 64 95 88 41 86 80 5 62 27 17 92 18 24 94 6 61 77 95 79 19 4 33 49 49 3 41 3 18 82 4 55 39 38 65 3 7 98 11 89 96 50 92 24 45 32 44 59 7 32 32 95 63 6 42 8 24 48 16 93 72 43 84 33 95 45 38 96 49 40 87 68 12 19 16 1 15 38 54 94 68 96 70 56 
32 93 96 63 54 80 6 39 73 61 65 99 5 3 79 98 30 74 7 92 6 75 68 37 61 48 11 7 36 47 57 7 79 73 41 87 90 97 55 88 74 72 13 31 84 93 85 42 13 24 26 94 30 1 99 31 20 73 55 85 46 11 4 43 95 73 63 21 19 7 11 3 80 85 41 58 38 63 72 1 57 51 8 91 42 52 39 13 98 14 45 16 13 24 55 94 94 27 1 87 
3 8 62 30 33 62 86 83 14 30 32 86 6 19 31 34 73 47 29 83 71 36 92 16 99 26 35 60 28 86 55 21 16 41 76 8 61 42 84 10 21 68 32 69 95 59 69 92 88 63 4 36 7 91 42 99 48 34 79 8 44 71 11 85 59 88 37 88 23 87 68 87 19 41 19 20 83 59 63 59 66 54 76 9 70 29 14 73 76 57 56 42 95 13 91 47 58 85 90 85 
80 15 66 61 63 16 35 39 18 89 65 99 98 39 8 95 38 72 26 79 18 85 65 45 100 74 59 17 62 3 70 11 93 15 62 20 21 30 66 76 33 99 33 75 86 27 26 100 2 52 40 10 93 22 55 17 21 1 40 76 67 88 84 23 18 87 49 54 48 36 90 43 91 15 71 76 66 63 46 3 82 2 24 45 38 86 91 87 21 12 99 59 13 32 60 70 59 1 71 72 
37 35 2 83 88 58 95 21 65 13 31 47 68 80 96 61 40 71 90 72 75 95 48 27 24 93 17 76 34 31 88 94 4 26 72 43 39 53 16 73 4 79 74 50 20 14 53 27 22 21 93 83 65 94 93 44 11 85 84 10 97 64 29 47 68 50 61 37 70 56 43 41 17 94 28 45 69 22 23 47 81 81 17 71 91 20 42 56 67 25 85 50 19 29 32 62 47 91 80 88 
64 84 78 7 31 29 15 74 76 63 97 77 53 96 22 92 22 95 23 55 40 33 76 55 5 94 55 47 44 47 9 5 74 92 45 28 93 44 5 25 6 48 81 66 15 76 40 72 86 8 64 98 34 71 66 6 100 19 24 7 50 66 68 37 14 90 52 13 59 88 44 46 98 16 48 69 84 94 78 22 100 20 51 94 27 51 35 47 37 90 16 93 20 25 24 42 84 26 15 30 
99 6 93 41 84 79 73 39 76 54 55 37 35 39 65 56 70 94 14 3 8 40 83 77 29 99 15 80 15 34 70 5 29 45 59 17 52 61 9 18 78 95 30 50 63 26 7 90 72 88 51 69 69 39 10 51 24 98 37 33 78 36 71 93 11 7 16 10 73 84 29 6 69 26 62 41 65 21 43 6 26 63 9 85 96 26 89 66 49 34 25 57 99 80 12 17 61 72 47 12 
