jobs 50
stage 8
machines 5 5 5 5 5 5 5 5 
*Pro_req*
1 5 3 2 1 1 2 1 5 3 5 2 2 4 4 5 5 4 3 5 2 3 5 4 3 2 3 1 2 1 1 5 4 2 5 5 3 3 2 2 5 1 2 1 5 1 5 4 3 3 
4 4 1 1 2 5 1 1 5 3 2 5 5 4 5 4 1 1 5 1 2 5 4 1 4 4 5 3 1 4 1 2 3 5 5 4 5 3 1 3 3 2 1 3 5 5 5 5 5 3 
2 2 5 2 2 1 2 5 1 3 2 3 5 5 3 4 2 3 1 5 2 3 4 5 3 3 3 4 4 4 3 3 5 2 1 4 4 3 2 5 5 1 5 1 2 5 1 4 5 3 
3 1 4 4 4 2 5 4 3 5 3 3 4 1 3 3 3 1 5 3 2 2 3 1 3 2 3 4 1 4 3 2 5 3 1 4 2 2 5 3 2 5 2 3 1 3 2 5 3 4 
3 5 5 1 1 5 3 4 1 5 4 1 4 3 1 2 2 5 1 1 5 4 1 2 3 1 5 3 3 2 5 3 2 4 1 2 2 2 2 5 5 2 1 3 5 2 5 4 3 2 
2 1 1 2 2 1 3 1 5 1 3 5 5 5 2 3 1 3 5 5 4 3 3 5 5 3 1 4 2 3 3 2 5 4 1 1 5 2 4 2 5 3 4 2 5 1 5 5 5 4 
5 4 2 5 5 1 1 5 1 3 2 4 1 5 3 3 3 4 3 5 5 3 2 5 3 1 2 4 2 1 1 4 4 2 3 3 4 5 4 1 3 5 2 1 2 5 5 2 4 5 
3 1 5 3 4 4 2 2 4 3 3 5 2 5 4 5 5 3 2 2 2 3 1 1 5 1 3 2 2 4 4 3 4 1 2 4 2 2 2 1 2 5 4 5 5 1 4 4 3 3 
*Pro_time*
21 34 9 40 84 44 24 82 22 89 90 2 79 72 27 49 56 24 26 57 59 83 71 28 78 3 24 12 63 59 7 76 88 61 88 11 47 41 22 73 69 89 52 86 11 22 58 96 30 56 
70 36 10 97 89 31 93 4 18 56 76 67 3 29 36 48 87 25 50 70 31 16 47 68 69 76 99 21 51 87 36 87 19 94 45 21 41 63 41 89 17 38 61 25 26 65 72 90 39 48 
77 31 95 39 2 75 32 72 66 7 27 74 77 16 16 18 22 88 60 89 41 31 28 40 96 67 83 10 84 90 96 72 46 34 63 5 95 64 74 49 15 12 80 77 28 70 7 19 92 81 
72 75 14 28 4 34 40 69 21 33 27 99 37 86 7 33 23 6 25 65 92 24 63 18 16 60 44 3 87 5 21 33 46 71 95 85 90 10 59 16 76 24 87 9 58 14 2 51 85 5 
10 77 67 92 41 84 30 99 91 58 26 31 41 63 22 4 11 29 71 35 12 99 100 70 50 82 21 6 83 1 49 70 32 13 6 98 50 31 20 25 7 50 86 32 28 66 26 98 4 77 
9 34 29 59 1 52 85 78 32 19 51 79 93 14 94 66 10 64 4 4 3 33 64 43 59 42 78 25 59 45 30 88 38 32 62 62 20 33 22 55 47 12 52 30 98 80 86 50 80 81 
24 75 73 86 16 90 85 24 39 18 48 73 3 81 80 48 61 78 68 91 93 51 84 70 49 37 41 25 42 97 8 30 15 9 53 13 71 76 66 2 66 18 98 18 90 79 38 51 33 7 
35 8 34 33 3 1 45 45 34 86 42 33 36 4 20 67 23 47 19 80 22 96 3 82 32 74 97 74 1 9 8 86 27 53 5 91 63 20 10 46 38 38 72 37 39 68 35 54 76 48 
