jobs 50
stage 8
machines 5 5 5 5 5 5 5 5 
*Pro_req*
4 2 1 5 4 2 5 4 2 1 4 2 4 4 3 1 2 2 4 4 5 5 3 5 5 3 3 5 3 1 1 3 3 4 1 5 3 2 1 5 5 3 5 5 1 1 2 1 5 1 
5 3 3 4 3 4 3 1 2 2 3 1 1 4 1 1 1 3 3 2 3 3 3 1 5 2 5 3 4 3 1 4 5 1 3 3 2 1 1 2 5 2 4 5 2 1 5 3 5 5 
4 2 2 3 2 5 4 1 3 2 1 4 5 5 1 3 3 4 2 4 3 2 5 4 2 2 5 5 4 4 4 3 3 1 3 1 5 3 1 2 5 2 5 5 4 4 3 3 5 2 
5 5 5 2 1 5 2 3 3 4 1 5 4 4 1 5 3 2 4 5 1 1 4 3 4 5 4 4 1 2 4 3 5 5 1 3 4 1 3 5 5 4 4 5 2 1 2 5 4 1 
3 3 2 5 4 4 5 2 2 3 5 1 3 5 2 5 2 3 3 1 3 3 1 2 5 1 1 1 2 1 2 4 2 3 5 2 2 5 4 3 1 2 4 1 5 3 1 3 1 3 
2 1 1 1 2 3 4 5 3 3 5 1 1 2 2 4 1 5 2 5 2 1 1 1 3 1 4 3 1 3 1 2 5 4 5 3 4 5 2 5 3 5 5 3 4 5 2 2 1 1 
1 2 5 4 2 3 2 4 3 4 4 2 3 4 3 3 5 2 5 5 3 4 1 5 4 1 3 3 1 3 3 5 2 4 1 3 5 4 1 1 1 3 4 3 1 3 2 1 3 3 
5 5 5 5 2 4 1 1 4 4 5 2 2 3 4 2 5 4 2 1 4 1 4 1 5 4 2 4 2 5 2 4 2 3 3 1 3 5 2 2 3 3 2 3 4 3 5 4 1 3 
*Pro_time*
36 74 58 4 69 87 93 5 63 88 72 50 8 98 8 83 13 65 77 10 79 52 42 68 52 25 4 48 17 3 8 27 99 55 38 99 28 100 12 67 9 53 66 1 8 71 71 54 34 22 
42 80 62 98 23 56 22 98 18 93 68 47 22 45 70 48 15 10 43 15 48 6 51 34 71 33 5 45 47 59 49 23 58 55 61 78 59 57 74 59 3 31 50 69 96 15 100 10 2 11 
32 79 5 62 45 48 92 76 3 45 21 87 7 81 64 40 79 1 64 37 46 46 72 48 1 64 97 13 65 39 63 92 22 89 9 86 31 46 89 95 100 69 83 42 94 33 18 65 49 83 
68 52 55 92 63 21 70 3 95 26 25 63 64 61 35 79 57 87 40 96 78 93 17 75 10 36 31 6 80 86 78 70 80 36 81 84 6 48 19 65 21 75 3 57 21 22 83 66 26 67 
97 18 15 94 9 24 41 88 55 80 73 26 98 15 50 67 18 91 17 67 84 94 85 15 1 98 35 62 74 97 92 17 38 2 73 41 94 46 14 62 16 53 87 37 100 7 28 64 12 18 
5 96 50 39 77 82 20 70 96 38 30 56 8 13 40 74 78 92 57 27 39 48 11 55 62 53 30 95 78 84 35 93 100 92 14 6 63 4 45 74 71 62 7 10 25 99 28 4 79 43 
50 17 86 37 13 50 48 67 4 13 50 19 27 94 16 54 16 72 55 69 12 28 31 77 66 93 54 71 17 18 3 94 1 50 43 3 38 79 14 78 44 53 74 43 45 4 42 76 82 49 
14 46 90 29 33 22 78 58 99 92 22 64 56 69 1 20 68 90 9 81 56 20 71 84 85 66 24 75 53 70 63 3 77 42 1 24 17 18 54 54 98 12 60 38 2 42 18 39 75 20 
