jobs 20
stage 5
machines 3 2 3 4 3 
*Pro_req*
2 1 1 2 3 3 2 1 3 1 3 2 1 1 1 3 3 1 1 2 
1 1 2 2 2 2 1 1 2 2 2 1 2 2 2 2 2 2 1 1 
2 3 3 1 1 1 1 1 3 3 2 2 2 3 1 1 2 1 1 1 
4 3 1 2 4 2 3 4 3 1 2 4 4 3 1 1 1 3 3 2 
1 2 2 1 1 1 2 3 3 3 2 1 1 2 3 1 3 2 2 1 
*Pro_time*
70 23 80 20 69 49 26 46 30 68 3 25 43 94 90 34 24 64 79 26 
16 52 60 70 11 96 46 15 51 68 90 30 56 84 8 82 54 53 97 52 
23 10 63 61 23 51 42 8 12 64 67 74 59 24 100 22 85 3 98 2 
42 79 10 99 17 52 47 11 39 64 9 8 78 67 8 74 80 47 50 32 
18 12 99 68 80 70 43 76 67 98 22 27 79 75 95 14 24 63 54 81 
