jobs 20
stage 5
machines 1 1 4 2 4 
*Pro_req*
1 1 1 1 1 1 1 1 1 1 1 1 1 1 1 1 1 1 1 1 
1 1 1 1 1 1 1 1 1 1 1 1 1 1 1 1 1 1 1 1 
1 1 3 4 3 4 1 3 4 4 1 4 3 3 1 1 4 3 2 2 
1 2 2 2 1 1 1 2 2 1 1 2 2 1 2 2 2 1 2 1 
1 3 1 1 4 1 2 4 4 1 3 3 2 4 2 4 4 3 4 2 
*Pro_time*
66 39 16 8 89 19 52 42 57 9 19 6 25 52 73 45 49 82 36 25 
75 89 47 32 43 80 40 41 70 28 92 91 63 67 31 95 91 45 96 73 
59 38 44 55 26 36 17 32 21 25 21 82 21 35 17 48 84 82 97 28 
22 24 71 57 1 40 25 62 58 53 24 3 12 10 57 12 72 53 1 32 
25 36 72 29 66 80 44 87 89 43 76 40 52 83 93 33 78 42 23 80 
