jobs 20
stage 5
machines 3 3 3 1 3 
*Pro_req*
3 3 1 2 1 3 3 1 1 3 2 1 2 1 3 1 1 3 1 1 
2 3 1 2 1 2 1 2 3 1 2 1 1 1 2 1 2 1 1 3 
2 2 1 1 2 2 3 1 2 2 3 2 1 3 3 3 2 2 3 2 
1 1 1 1 1 1 1 1 1 1 1 1 1 1 1 1 1 1 1 1 
3 1 3 3 2 2 1 1 2 3 2 1 3 3 3 1 3 2 3 3 
*Pro_time*
42 72 83 62 93 17 76 96 1 36 61 54 99 25 22 99 7 9 25 35 
14 67 80 94 44 65 34 36 25 61 67 14 96 11 23 67 49 14 50 59 
69 55 24 30 31 79 28 18 64 56 76 91 66 59 71 90 88 87 43 54 
85 75 83 98 89 70 15 31 70 95 17 25 1 48 98 9 3 77 53 12 
84 74 37 42 21 43 97 53 36 5 91 42 83 77 44 74 52 31 65 28 
