jobs 20
stage 5
machines 2 1 2 3 2 
*Pro_req*
1 2 2 2 1 1 1 1 2 1 2 2 2 2 2 1 2 1 2 1 
1 1 1 1 1 1 1 1 1 1 1 1 1 1 1 1 1 1 1 1 
2 1 1 2 2 1 1 1 2 2 2 1 2 2 1 1 1 2 2 2 
1 1 3 2 3 1 2 3 2 1 2 1 1 3 3 3 2 2 3 1 
1 1 2 1 1 2 2 2 1 1 1 1 1 2 2 1 2 2 1 2 
*Pro_time*
77 33 33 12 32 13 66 77 21 62 86 8 15 20 32 79 34 51 68 18 
7 84 62 4 20 83 55 23 33 92 45 24 47 12 2 40 76 35 66 20 
85 34 26 63 25 22 14 11 2 49 60 21 31 35 35 25 34 75 37 13 
82 50 3 6 51 58 55 55 13 78 14 39 99 2 25 45 9 11 28 31 
95 45 15 25 34 12 41 57 67 21 74 61 52 31 83 3 72 36 85 6 
