jobs 20
stage 5
machines 4 4 2 2 4 
*Pro_req*
3 3 2 3 3 2 1 2 2 1 4 4 3 3 2 3 2 1 1 2 
1 3 2 1 4 4 2 3 1 4 2 1 3 4 1 1 2 1 4 3 
2 2 1 1 1 1 1 2 2 1 1 1 1 2 2 2 1 2 2 1 
1 2 1 1 2 2 1 2 1 1 1 2 1 2 2 1 2 1 1 1 
2 1 2 3 1 1 3 3 3 2 4 1 1 1 2 2 3 2 1 3 
*Pro_time*
29 73 96 29 81 73 81 81 95 10 29 73 80 61 15 36 47 51 20 72 
84 55 82 46 40 3 2 30 67 91 28 44 54 84 29 24 69 38 84 22 
89 67 59 96 100 36 81 4 84 80 48 79 71 54 97 16 36 19 61 82 
6 56 17 76 51 97 46 80 43 33 47 1 31 11 77 77 11 53 14 5 
65 68 36 61 89 21 44 34 61 33 61 47 1 77 28 79 55 11 35 92 
