jobs 20
stage 5
machines 2 2 1 2 5 
*Pro_req*
2 1 2 2 1 2 2 2 2 1 1 2 2 2 2 1 1 1 1 1 
2 1 2 1 1 2 2 2 2 1 1 2 2 2 2 1 2 2 1 1 
1 1 1 1 1 1 1 1 1 1 1 1 1 1 1 1 1 1 1 1 
2 2 1 2 1 1 1 1 2 2 2 2 2 1 2 2 1 1 2 1 
2 5 3 3 1 4 3 1 4 5 3 4 1 5 2 5 4 4 1 3 
*Pro_time*
37 69 6 23 92 33 72 29 28 86 38 71 3 56 96 53 53 50 9 9 
12 85 92 4 16 52 74 77 13 57 27 18 51 70 89 38 4 98 91 44 
35 83 15 81 63 57 36 60 82 49 57 77 65 64 20 39 6 38 51 34 
79 97 22 100 56 49 13 70 7 66 6 36 56 28 58 47 15 72 12 71 
47 85 9 19 71 44 62 74 66 73 25 27 90 67 23 8 33 69 13 50 
