jobs 20
stage 8
machines 4 2 3 4 1 2 3 1 
*Pro_req*
4 4 2 2 1 4 3 1 3 2 2 3 2 2 1 1 4 2 4 4 
2 1 1 1 1 2 2 2 1 1 1 1 2 2 2 1 2 2 2 1 
2 2 1 1 1 2 1 2 1 2 3 2 1 3 1 2 2 3 2 1 
2 2 2 3 2 3 4 2 2 2 2 3 1 1 3 2 3 1 1 2 
1 1 1 1 1 1 1 1 1 1 1 1 1 1 1 1 1 1 1 1 
2 2 2 2 2 2 1 2 2 2 2 1 1 1 1 1 2 2 2 1 
3 2 3 1 1 3 3 1 2 2 2 1 3 1 2 3 2 3 1 1 
1 1 1 1 1 1 1 1 1 1 1 1 1 1 1 1 1 1 1 1 
*Pro_time*
10 65 79 13 44 50 97 45 70 33 8 98 51 81 60 11 98 99 66 26 
11 9 60 17 17 64 50 17 97 87 54 20 21 66 45 92 86 34 7 15 
24 1 35 80 49 53 47 41 2 18 53 34 14 2 23 47 59 28 52 39 
92 93 23 91 8 4 88 33 38 49 96 85 95 24 18 14 27 51 29 18 
81 86 24 28 98 35 63 17 90 89 69 18 10 43 12 32 36 26 65 65 
66 8 1 94 91 25 40 83 14 19 91 56 24 43 12 47 76 85 70 51 
47 70 77 9 33 23 14 68 87 19 8 2 76 48 86 91 72 99 65 51 
30 44 36 19 56 17 14 91 68 91 78 47 46 47 24 84 62 87 73 51 
