jobs 20
stage 8
machines 3 2 4 4 5 2 4 4 
*Pro_req*
3 1 2 2 3 3 3 1 3 1 3 2 3 1 1 2 1 1 1 1 
1 1 2 1 2 2 1 2 1 2 2 1 1 1 2 2 2 2 1 2 
1 2 2 3 1 2 2 3 1 1 4 4 2 2 3 4 4 4 2 4 
1 4 2 1 2 1 2 1 4 4 2 2 2 3 2 4 3 1 2 4 
5 3 5 2 1 5 5 5 3 4 3 5 4 4 5 5 2 4 4 5 
1 1 2 1 1 1 1 2 1 2 1 1 1 1 1 1 1 1 1 2 
4 2 2 1 4 4 2 3 1 4 1 2 1 1 1 2 4 4 4 1 
1 4 2 1 4 4 3 1 3 4 1 4 2 1 1 2 4 2 1 1 
*Pro_time*
95 63 34 6 75 79 98 60 89 88 96 12 56 7 41 72 24 82 76 99 
3 60 35 6 11 10 89 12 69 32 20 37 80 98 41 90 61 50 97 36 
81 25 82 47 27 91 73 53 91 90 17 71 34 91 13 9 54 8 26 77 
74 51 89 81 69 32 51 21 38 51 72 58 68 51 47 50 46 85 29 93 
47 68 4 58 80 29 34 81 16 66 46 2 23 20 61 75 93 20 85 80 
63 14 44 43 97 56 61 54 6 37 35 88 32 65 79 37 23 40 12 78 
18 36 80 47 58 46 26 42 45 40 25 18 63 73 90 80 43 93 74 87 
9 29 19 8 28 15 74 99 61 97 75 66 44 1 33 66 43 36 25 69 
