jobs 20
stage 8
machines 3 2 4 5 5 5 2 4 
*Pro_req*
3 3 2 2 1 1 2 2 3 3 2 1 3 3 2 1 1 3 2 1 
2 2 2 1 2 2 2 1 1 2 1 1 1 2 1 1 2 2 1 2 
4 4 3 1 1 2 3 1 3 2 1 2 2 1 2 1 1 1 2 4 
1 4 3 5 3 5 5 5 1 3 3 2 5 5 2 5 2 4 1 5 
5 3 4 2 3 3 2 3 2 2 5 2 2 4 4 2 3 2 5 3 
4 4 3 1 1 5 3 5 4 4 2 3 4 5 5 3 1 5 1 5 
2 1 2 2 1 1 2 1 1 2 1 2 1 2 2 1 1 2 2 1 
2 3 2 4 1 3 4 1 3 3 1 3 2 2 4 1 3 4 4 4 
*Pro_time*
95 46 6 62 68 44 67 71 2 10 32 94 25 12 46 9 36 2 92 94 
68 57 63 97 65 93 90 16 63 37 33 19 41 26 56 44 55 12 1 94 
39 12 1 40 92 99 76 93 15 78 29 88 57 98 79 3 36 75 74 27 
90 82 65 88 87 37 18 30 3 88 53 21 55 47 85 3 86 78 1 3 
71 83 48 56 96 13 52 38 91 73 15 11 13 46 18 6 43 49 91 67 
67 53 24 95 53 85 31 98 56 5 14 93 13 63 35 14 26 69 31 59 
60 21 50 51 87 60 45 48 8 79 29 5 81 72 32 33 63 12 53 49 
96 31 99 53 50 66 58 23 46 47 22 14 55 95 50 69 65 44 38 87 
