jobs 20
stage 8
machines 5 5 5 5 5 5 5 5 
*Pro_req*
3 2 4 4 2 4 5 1 3 1 1 5 5 3 1 4 4 1 3 5 
5 5 2 4 2 4 5 5 2 1 5 3 5 4 5 3 1 4 2 5 
2 2 5 1 4 2 3 4 2 3 3 5 1 3 2 1 2 3 2 4 
2 2 3 3 2 5 1 3 5 3 5 1 1 2 1 4 1 1 1 3 
5 1 3 4 3 4 3 4 1 1 4 3 5 5 1 5 3 4 3 3 
1 1 3 4 2 5 4 1 2 1 1 1 5 2 1 3 4 1 3 3 
1 2 1 5 4 1 3 4 5 5 2 4 1 1 3 2 1 1 4 3 
4 3 1 3 1 2 3 2 5 5 5 2 3 3 2 4 1 4 1 2 
*Pro_time*
60 8 6 58 72 19 16 47 48 72 32 9 71 88 100 88 1 52 79 94 
35 4 28 83 63 43 54 19 73 98 81 24 46 65 63 36 45 45 17 56 
23 75 88 11 9 7 82 39 5 46 61 58 4 91 76 96 84 52 55 73 
94 4 37 99 11 64 82 43 8 35 96 41 65 62 43 57 34 13 31 56 
64 79 99 30 36 77 23 51 96 52 41 21 28 82 51 100 9 65 47 53 
28 35 93 46 5 97 38 21 31 25 49 25 78 83 96 3 91 31 15 32 
2 9 29 42 92 94 51 12 15 66 64 9 72 88 53 69 14 5 49 44 
60 75 69 47 28 42 16 55 26 100 1 25 88 66 56 22 93 49 76 4 
