jobs 20
stage 8
machines 5 5 5 5 5 5 5 5 
*Pro_req*
1 5 3 2 1 1 2 1 5 3 5 2 2 4 4 5 5 4 3 5 
5 1 2 1 5 1 5 4 3 3 2 2 1 2 5 3 2 5 2 5 
1 4 5 4 5 1 3 3 2 4 4 5 3 5 1 2 3 5 2 3 
2 5 4 1 4 4 5 3 1 4 1 2 3 5 5 4 5 3 1 3 
4 4 1 2 2 3 5 2 3 4 2 1 3 4 4 4 5 2 3 5 
2 2 5 2 2 1 2 5 1 3 2 3 5 5 3 4 2 3 1 5 
5 1 5 1 2 5 1 4 5 3 4 2 5 2 1 4 2 4 4 1 
5 4 3 2 4 1 5 4 4 3 1 1 4 4 2 4 1 1 5 5 
*Pro_time*
36 58 82 74 57 25 52 5 35 19 15 88 69 40 84 82 48 51 34 24 
90 2 79 72 27 49 56 24 26 57 59 83 71 28 78 3 24 12 63 59 
69 77 10 17 26 94 4 1 88 60 34 81 88 75 82 80 2 1 90 11 
42 23 4 50 88 92 90 93 97 43 70 36 10 97 89 31 93 4 18 56 
36 87 19 94 45 21 41 63 41 89 17 38 61 25 26 65 72 90 39 48 
32 49 65 100 47 47 60 79 69 67 48 49 87 38 9 72 65 45 37 83 
27 74 77 16 16 18 22 88 60 89 41 31 28 40 96 67 83 10 84 90 
53 2 76 61 75 32 91 68 48 81 59 45 70 19 52 47 54 15 84 53 
