jobs 20
stage 8
machines 5 5 5 5 5 5 5 5 
*Pro_req*
3 5 4 1 1 4 3 2 1 4 4 1 3 5 2 2 1 4 1 2 
4 4 2 4 5 4 2 3 2 1 2 2 2 5 1 1 2 1 5 2 
5 5 1 5 2 3 5 1 5 3 1 4 2 1 4 3 5 5 5 1 
1 3 4 3 3 4 3 4 5 4 3 4 4 3 2 2 1 3 2 4 
2 1 4 4 5 2 5 1 2 1 5 4 2 3 5 5 2 4 3 1 
2 4 5 1 3 3 2 2 5 2 5 3 1 2 4 2 1 2 3 4 
5 4 4 3 4 1 1 4 3 3 5 5 5 5 4 2 3 4 4 3 
2 2 4 1 1 3 2 4 3 1 5 3 1 2 1 3 4 2 2 5 
*Pro_time*
55 68 42 52 69 85 37 86 7 22 67 67 46 11 98 44 59 23 20 98 
17 81 75 37 21 87 96 52 29 44 77 78 71 22 68 87 90 68 26 24 
7 82 56 90 14 14 72 98 69 12 100 81 65 50 53 82 43 42 28 50 
72 30 35 39 73 21 66 52 20 31 76 80 80 72 80 29 60 64 82 36 
30 26 7 63 59 74 59 44 79 44 41 47 55 58 39 56 32 78 84 61 
7 94 28 26 72 76 13 23 10 8 85 14 99 86 46 68 60 44 80 46 
77 29 27 5 25 60 39 93 69 30 37 97 74 95 9 89 58 67 11 96 
41 2 73 13 48 74 53 84 12 4 57 14 86 87 92 61 53 18 81 8 
