jobs 10
stage 5
machines 2 3 2 5 4 
*Pro_req*
2 2 1 1 1 2 1 1 2 1 
1 3 1 2 3 2 3 1 3 3 
1 2 2 2 2 2 2 2 1 2 
1 5 2 4 1 3 3 1 3 4 
1 4 2 4 1 2 2 4 4 1 
*Pro_time*
25 71 38 85 65 62 96 92 100 53 
38 91 65 85 71 96 10 32 81 3 
1 49 84 35 53 80 91 54 72 63 
47 24 69 54 47 77 2 9 96 36 
89 39 28 15 5 14 25 13 84 22 
