jobs 10
stage 5
machines 2 3 4 3 4 
*Pro_req*
1 2 2 1 1 2 1 2 1 1 
3 1 2 2 3 3 2 2 2 3 
2 2 1 2 1 3 1 3 3 1 
1 2 3 1 2 3 3 2 2 2 
3 1 4 2 2 2 3 4 1 2 
*Pro_time*
84 63 91 34 7 95 63 28 21 43 
21 97 41 6 29 99 65 58 29 96 
64 95 56 73 38 73 73 93 84 84 
95 78 6 11 50 44 32 73 32 23 
59 12 92 72 65 68 67 3 92 59 
