jobs 10
stage 5
machines 3 5 3 2 3 
*Pro_req*
2 2 2 1 3 1 2 1 3 2 
2 4 5 5 3 3 1 5 3 5 
1 3 3 1 1 1 2 1 1 1 
1 2 1 2 1 2 1 2 1 2 
3 2 2 3 2 1 2 3 3 2 
*Pro_time*
76 53 85 51 26 72 9 61 37 4 
94 93 92 60 100 75 89 20 30 51 
85 4 27 76 24 85 14 16 100 11 
37 35 97 53 79 3 49 73 48 100 
53 89 39 100 12 96 21 63 51 1 
