jobs 10
stage 5
machines 3 4 1 5 2 
*Pro_req*
1 3 2 2 2 3 1 1 3 1 
4 2 3 1 4 3 4 2 4 1 
1 1 1 1 1 1 1 1 1 1 
5 2 3 4 5 1 2 5 4 5 
1 2 1 2 1 1 2 1 1 2 
*Pro_time*
85 21 6 11 30 33 4 21 60 29 
82 100 36 96 30 66 35 18 41 85 
82 84 76 10 52 46 21 45 25 79 
49 19 12 17 81 68 63 68 25 38 
42 28 63 51 91 75 15 98 31 60 
