jobs 10
stage 5
machines 4 1 1 2 5 
*Pro_req*
3 1 2 4 3 2 1 3 2 2 
1 1 1 1 1 1 1 1 1 1 
1 1 1 1 1 1 1 1 1 1 
2 2 1 1 2 1 2 1 2 2 
5 5 3 4 3 3 5 5 3 4 
*Pro_time*
4 92 54 56 11 89 77 85 38 63 
1 71 18 13 30 90 76 90 79 18 
74 65 31 72 88 39 37 24 37 45 
69 22 41 91 67 96 13 74 11 100 
30 19 3 19 33 15 51 23 19 27 
