jobs 10
stage 5
machines 3 4 1 2 5 
*Pro_req*
1 3 1 2 3 2 1 3 3 1 
3 4 1 2 1 2 2 3 3 2 
1 1 1 1 1 1 1 1 1 1 
2 1 1 2 1 1 1 1 2 2 
3 3 1 3 1 4 4 2 3 2 
*Pro_time*
11 78 34 47 15 8 75 62 91 100 
44 55 89 49 60 26 9 11 87 21 
22 14 52 77 64 87 69 27 46 19 
75 85 57 29 70 92 68 32 27 5 
35 38 69 93 20 18 93 31 86 69 
