jobs 10
stage 5
machines 1 1 2 5 4 
*Pro_req*
1 1 1 1 1 1 1 1 1 1 
1 1 1 1 1 1 1 1 1 1 
2 2 2 1 2 1 2 2 2 2 
3 1 3 3 1 4 3 2 3 5 
1 3 1 4 3 2 1 1 1 1 
*Pro_time*
42 3 17 76 59 40 67 38 98 34 
63 32 53 29 27 83 58 42 67 35 
91 37 86 82 86 40 74 10 64 21 
56 93 90 89 43 85 41 63 95 55 
13 41 13 91 91 84 7 63 86 43 
