jobs 10
stage 5
machines 2 1 5 3 3 
*Pro_req*
2 2 1 2 1 2 2 1 2 1 
1 1 1 1 1 1 1 1 1 1 
3 2 3 4 2 4 3 5 1 3 
1 2 2 2 2 1 2 3 3 2 
2 1 1 1 2 1 1 3 3 3 
*Pro_time*
10 33 51 39 67 16 72 41 63 34 
98 96 12 45 49 98 3 40 75 63 
15 69 91 39 10 37 28 92 73 56 
77 31 89 91 2 69 35 1 3 81 
34 88 14 40 30 79 11 51 76 17 
