jobs 10
stage 8
machines 5 5 5 5 5 5 5 5 
*Pro_req*
2 1 4 4 3 2 5 3 5 4 
1 3 3 3 3 5 1 5 5 3 
2 2 1 2 5 1 5 2 4 1 
5 2 3 3 5 4 4 4 1 2 
4 2 2 1 3 1 1 4 3 3 
4 2 5 2 4 5 4 2 4 4 
1 4 1 5 5 5 5 5 4 1 
4 2 4 2 4 4 4 4 2 1 
*Pro_time*
65 8 98 57 64 98 50 34 39 95 
19 22 20 1 25 36 55 26 44 82 
68 68 66 12 8 16 44 94 13 76 
27 53 64 57 99 17 92 18 11 80 
15 66 34 100 13 23 6 34 17 2 
47 35 44 93 94 46 94 57 38 84 
12 75 93 2 77 74 46 21 33 35 
22 11 50 45 4 67 27 60 59 76 
