jobs 10
stage 8
machines 5 5 5 5 5 5 5 5 
*Pro_req*
1 2 5 5 3 2 5 1 2 5 
3 2 3 1 3 5 1 1 3 3 
2 1 4 1 3 2 3 5 4 5 
5 3 5 3 2 2 3 1 2 2 
5 5 4 5 2 3 5 1 1 5 
1 5 3 4 5 2 1 5 4 5 
3 3 2 4 1 1 2 3 3 5 
1 5 3 1 5 5 1 5 3 5 
*Pro_time*
69 38 9 35 81 94 74 60 53 94 
26 77 100 31 75 3 16 69 57 82 
16 29 48 75 18 1 50 35 72 58 
55 30 64 47 70 94 38 39 11 81 
18 63 28 48 65 38 26 80 65 24 
30 43 33 58 28 9 69 44 85 50 
43 47 8 11 74 47 4 78 70 55 
19 53 70 98 84 78 89 48 9 28 
