jobs 10
stage 8
machines 5 5 5 5 5 5 5 5 
*Pro_req*
4 3 1 2 1 5 4 5 3 2 
2 1 5 4 2 2 3 4 2 5 
5 5 2 4 5 5 2 3 5 5 
1 3 5 4 3 5 2 1 4 4 
3 3 4 2 1 3 5 4 5 1 
4 5 1 1 3 4 5 5 2 5 
1 3 4 1 4 4 5 2 2 3 
3 4 3 4 4 3 4 5 1 3 
*Pro_time*
22 58 53 11 67 58 83 15 13 55 
89 97 13 24 37 100 68 63 53 87 
89 63 63 21 88 41 98 88 84 72 
55 49 83 81 53 19 52 74 77 72 
29 14 97 31 23 11 42 18 61 11 
16 93 39 21 66 49 32 78 65 88 
4 52 22 44 54 76 59 93 59 85 
100 39 29 71 91 63 19 42 32 52 
