jobs 10
stage 8
machines 5 5 5 5 5 5 5 5 
*Pro_req*
1 4 3 1 3 1 4 2 2 3 
5 5 4 5 4 5 1 4 1 4 
3 4 1 2 5 5 2 1 5 5 
4 5 5 5 2 4 5 1 3 5 
1 2 2 1 4 3 1 1 1 5 
2 1 1 3 4 5 1 4 3 4 
1 3 5 5 4 5 2 1 2 2 
3 4 2 5 4 1 1 2 3 2 
*Pro_time*
51 14 58 48 51 61 1 29 53 79 
74 51 74 71 17 60 30 49 87 87 
20 20 75 62 42 7 42 37 29 39 
34 68 64 1 8 94 100 69 90 75 
76 27 31 65 7 79 67 10 66 41 
5 26 91 100 98 38 3 38 62 85 
82 75 93 2 64 16 83 65 56 72 
30 26 71 35 36 70 30 65 95 68 
