jobs 10
stage 8
machines 5 5 5 5 5 5 5 5 
*Pro_req*
2 2 4 4 1 1 4 2 3 3 
1 3 2 5 4 1 4 2 1 1 
4 2 2 4 2 3 3 2 1 1 
2 4 3 1 2 3 5 1 4 5 
2 1 1 1 3 2 3 2 1 2 
1 2 2 2 4 2 5 2 2 4 
1 2 4 3 4 5 2 5 1 5 
2 5 3 3 4 2 4 3 2 2 
*Pro_time*
89 22 53 97 11 84 80 69 99 99 
82 90 3 59 29 82 47 39 93 48 
68 94 67 10 40 83 8 92 11 75 
52 30 100 8 91 80 63 29 10 40 
55 11 91 9 23 56 30 51 47 82 
11 1 73 90 85 74 53 45 70 19 
73 16 17 35 66 73 78 93 32 69 
2 15 97 18 94 59 52 83 60 65 
