jobs 10
stage 8
machines 5 5 5 5 5 5 5 5 
*Pro_req*
1 2 2 2 2 2 3 3 3 1 
4 1 4 4 2 5 4 1 2 4 
3 4 1 5 5 1 4 3 2 5 
5 3 1 1 3 5 1 4 5 1 
4 4 3 1 3 2 2 2 1 4 
3 4 4 4 2 5 1 2 5 3 
4 1 5 5 1 3 2 5 1 1 
5 3 3 5 1 5 4 5 3 1 
*Pro_time*
27 93 32 89 16 4 74 87 70 37 
24 18 61 13 41 87 79 58 7 81 
58 96 31 77 92 80 25 88 7 2 
78 26 24 53 99 55 98 8 23 41 
95 75 36 92 92 11 97 19 72 54 
79 7 80 15 28 51 15 44 63 30 
83 50 15 36 73 38 91 16 4 41 
48 71 56 77 94 51 33 6 62 69 
