jobs 10
stage 8
machines 5 5 5 5 5 5 5 5 
*Pro_req*
1 5 2 2 5 2 2 5 4 4 
5 4 4 5 5 4 4 3 4 2 
3 5 3 5 3 4 3 3 5 2 
3 5 3 2 1 2 5 2 4 5 
3 2 1 2 3 3 2 2 1 2 
4 4 5 2 5 2 5 2 4 1 
2 2 1 4 4 3 5 5 3 1 
1 4 4 5 2 4 3 1 1 2 
*Pro_time*
15 19 70 39 67 9 1 40 7 98 
71 24 77 16 86 80 99 56 64 23 
10 9 27 16 51 42 82 80 58 42 
42 96 95 40 38 58 70 35 48 95 
94 83 32 72 68 92 27 62 4 68 
13 41 95 82 87 12 12 84 83 38 
39 84 60 5 60 15 35 16 44 86 
88 42 97 63 15 72 30 83 70 41 
