jobs 10
stage 8
machines 5 5 5 5 5 5 5 5 
*Pro_req*
5 5 3 1 5 1 2 3 1 3 
4 4 1 5 1 4 2 2 3 2 
2 5 3 1 1 2 4 2 1 3 
5 5 2 5 3 5 2 3 1 1 
3 3 1 4 5 1 2 5 2 1 
3 5 1 3 2 2 3 4 2 5 
5 4 3 5 1 5 1 2 4 2 
3 2 2 5 4 4 3 5 1 3 
*Pro_time*
47 3 70 39 75 98 63 32 36 11 
84 34 93 65 25 86 69 6 93 94 
65 6 88 63 52 95 13 8 6 34 
72 21 47 66 57 39 4 30 51 80 
30 39 85 32 36 19 76 77 44 91 
72 18 59 53 49 14 81 91 60 75 
63 89 16 43 44 55 28 14 44 32 
32 21 41 77 94 74 24 47 88 1 
